小星星(純伴奏)=ㄒㄒㄒ(ㄔㄅㄗ)
我醒著做夢=ㄨㄒㄓㄗㄇ
忘情水(純伴奏)=ㄨㄑㄕ(ㄔㄅㄗ)
朋友情(純伴奏)=ㄆㄧㄑ(ㄔㄅㄗ)
知道=ㄓㄉ
風！告訴我(純伴奏)=ㄈ！ㄍㄙㄨ(ㄔㄅㄗ)
媽媽的願望=ㄇㄇㄉㄩㄨ
五月天,周杰倫=ㄨㄩㄊ,ㄓㄐㄌ
幸福的臉=ㄒㄈㄉㄌ
時間有淚=ㄕㄐㄧㄌ
白天不懂夜的黑=ㄅㄊㄅㄉㄧㄉㄏ
當你和心跳一起出現=ㄉㄋㄏㄒㄊㄧㄑㄔㄒ
相信愛=ㄒㄒㄞ
宇恆=ㄩㄏ
光=ㄍ
玖壹壹,黃明志=ㄐㄧㄧ,ㄏㄇㄓ
斷訊=ㄉㄒ
笑納=ㄒㄋ
無人來作伴=ㄨㄖㄌㄗㄅ
大塚愛=ㄉㄓㄞ
原點=ㄩㄉ
餘年(純伴奏)=ㄩㄋ(ㄔㄅㄗ)
有你就有我(純伴奏)=ㄧㄋㄐㄧㄨ(ㄔㄅㄗ)
仰望(純伴奏)=ㄧㄨ(ㄔㄅㄗ)
英雄寞=ㄧㄒㄇ
特務=ㄊㄨ
開口=ㄎㄎ
丁世光=ㄉㄕㄍ
銀臨,阿杰=ㄧㄌ,ㄚㄐ
三個人的晚餐=ㄙㄍㄖㄉㄨㄘ
愛你入骨=ㄞㄋㄖㄍ
無言的結局(純伴奏)=ㄨㄧㄉㄐㄐ(ㄔㄅㄗ)
千千萬萬(純伴奏)=ㄑㄑㄨㄨ(ㄔㄅㄗ)
愛不對時=ㄞㄅㄉㄕ
擔輸贏=ㄉㄕㄧ
愛情復興(純伴奏)=ㄞㄑㄈㄒ(ㄔㄅㄗ)
王琪=ㄨㄑ
舞極限=ㄨㄐㄒ
華晨宇=ㄏㄔㄩ
羅大佑=ㄌㄉㄧ
再見只是陌生人(純伴奏)=ㄗㄐㄓㄕㄇㄕㄖ(ㄔㄅㄗ)
玖壹壹=ㄐㄧㄧ
刻在我心底的名字(純伴奏)=ㄎㄗㄨㄒㄉㄉㄇㄗ(ㄔㄅㄗ)
巴別塔慶典=ㄅㄅㄊㄑㄉ
不用告訴我(純伴奏)=ㄅㄩㄍㄙㄨ(ㄔㄅㄗ)
旋木=ㄒㄇ
你走天橋我走地下道=ㄋㄗㄊㄑㄨㄗㄉㄒㄉ
高向鵬傅振輝=ㄍㄒㄆㄈㄓㄏ
曲盡陳情(純伴奏)=ㄑㄐㄔㄑ(ㄔㄅㄗ)
在我眼中開出玫瑰=ㄗㄨㄧㄓㄎㄔㄇㄍ
曹格,卓文萱=ㄘㄍ,ㄓㄨㄒ
渴了=ㄎㄌ
青春來紡見=ㄑㄔㄌㄈㄐ
麻醉=ㄇㄗ
青春無敵=ㄑㄔㄨㄉ
月娘我問你=ㄩㄋㄨㄨㄋ
終於說出口(純伴奏)=ㄓㄩㄕㄔㄎ(ㄔㄅㄗ)
幸运符号=ㄒㄩㄈㄏ
啞巴情歌=ㄧㄅㄑㄍ
七里香(純伴奏)=ㄑㄌㄒ(ㄔㄅㄗ)
今夜又擱為你醉=ㄐㄧㄧㄍㄨㄋㄗ
芥末不辣=ㄐㄇㄅㄌ
讀你=ㄉㄋ
坂本冬美=ㄅㄅㄉㄇ
沸騰(純伴奏)=ㄈㄊ(ㄔㄅㄗ)
美好的旅行=ㄇㄏㄉㄌㄒ
陳潔儀=ㄔㄐㄧ
有你在身旁=ㄧㄋㄗㄕㄆ
異鄉悲戀夢=ㄧㄒㄅㄌㄇ
來了=ㄌㄌ
我的未來不是夢(純伴奏)=ㄨㄉㄨㄌㄅㄕㄇ(ㄔㄅㄗ)
丘丘合唱團=ㄑㄑㄏㄔㄊ
陶大偉孫越=ㄊㄉㄨㄙㄩ
三百六十五里路=ㄙㄅㄌㄕㄨㄌㄌ
台北下的雨=ㄊㄅㄒㄉㄩ
徐紫淇=ㄒㄗㄑ
黃明志,鄧紫棋=ㄏㄇㄓ,ㄉㄗㄑ
阿杜=ㄚㄉ
許富凱=ㄒㄈㄎ
思念總在分手後(純伴奏)=ㄙㄋㄗㄗㄈㄕㄏ(ㄔㄅㄗ)
光之海=ㄍㄓㄏ
媽媽請你不通痛(純伴奏)=ㄇㄇㄑㄋㄅㄊㄊ(ㄔㄅㄗ)
光引擎樂團=ㄍㄧㄑㄩㄊ
碼頭惜別(純伴奏)=ㄇㄊㄒㄅ(ㄔㄅㄗ)
思念的日子(純伴奏)=ㄙㄋㄉㄖㄗ(ㄔㄅㄗ)
飲千杯=ㄧㄑㄅ
星晴(純伴奏)=ㄒㄑ(ㄔㄅㄗ)
菊梓喬=ㄐㄗㄑ
眼淚流回去=ㄧㄌㄌㄏㄑ
黃鴻升,柯有倫,竇智孔=ㄏㄏㄕ,ㄎㄧㄌ,ㄉㄓㄎ
當你孤單你會想起誰=ㄉㄋㄍㄉㄋㄏㄒㄑㄕ
句點=ㄐㄉ
牽絲戲=ㄑㄙㄒ
神木與瞳=ㄕㄇㄩㄊ
小宇=ㄒㄩ
帶我去找夜生活=ㄉㄨㄑㄓㄧㄕㄏ
我要愛慕祢=ㄨㄧㄞㄇㄋ
張玉華=ㄓㄩㄏ
男性苦戀=ㄋㄒㄎㄌ
傷心夢=ㄕㄒㄇ
很晚的晚安=ㄏㄨㄉㄨㄢ
情生意動=ㄑㄕㄧㄉ
幸福摩天輪(純伴奏)=ㄒㄈㄇㄊㄌ(ㄔㄅㄗ)
不甘心不放手(純伴奏)=ㄅㄍㄒㄅㄈㄕ(ㄔㄅㄗ)
絕對發言(純伴奏)=ㄐㄉㄈㄧ(ㄔㄅㄗ)
她以為她很美麗(純伴奏)=ㄊㄧㄨㄊㄏㄇㄌ(ㄔㄅㄗ)
我選的天空=ㄨㄒㄉㄊㄎ
愛過你有多久就有多痛=ㄞㄍㄋㄧㄉㄐㄐㄧㄉㄊ
相思爬上心底(純伴奏)=ㄒㄙㄆㄕㄒㄉ(ㄔㄅㄗ)
溫暖的心=ㄨㄋㄉㄒ
不想這是場戲(純伴奏)=ㄅㄒㄓㄕㄔㄒ(ㄔㄅㄗ)
回鄉的我=ㄏㄒㄉㄨ
告別我=ㄍㄅㄨ
沒有人知的故事=ㄇㄧㄖㄓㄉㄍㄕ
無言的結局=ㄨㄧㄉㄐㄐ
疼愛=ㄊㄞ
堅持=ㄐㄔ
天下一定是咱的=ㄊㄒㄧㄉㄕㄗㄉ
愛情三溫暖=ㄞㄑㄙㄨㄋ
世界第一等=ㄕㄐㄉㄧㄉ
下一個人=ㄒㄧㄍㄖ
周筆暢=ㄓㄅㄔ
我喜歡你快樂=ㄨㄒㄏㄋㄎㄌ
林淑容=ㄌㄕㄖ
第十行星=ㄉㄕㄒㄒ
潘瑋柏=ㄆㄨㄅ
當愛在靠近=ㄉㄞㄗㄎㄐ
無聲雨=ㄨㄕㄩ
大眼睛=ㄉㄧㄐ
暗淡的月(純伴奏)=ㄢㄉㄉㄩ(ㄔㄅㄗ)
這個讚=ㄓㄍㄗ
再愛一遍(純伴奏)=ㄗㄞㄧㄅ(ㄔㄅㄗ)
劉增瞳=ㄌㄗㄊ
蔡旻佑,天心=ㄘㄇㄧ,ㄊㄒ
沒理由=ㄇㄌㄧ
十二樓=ㄕㄦㄌ
黃子軒與山平快=ㄏㄗㄒㄩㄕㄆㄎ
時間都去哪兒了=ㄕㄐㄉㄑㄋㄦㄌ
張碧晨=ㄓㄅㄔ
你怎麼連話都說不清楚(純伴奏)=ㄋㄗㄇㄌㄏㄉㄕㄅㄑㄔ(ㄔㄅㄗ)
止戰之殤=ㄓㄓㄓㄕ
不能說的秘密(純伴奏)=ㄅㄋㄕㄉㄇㄇ(ㄔㄅㄗ)
繼續給歲的自己=ㄐㄒㄍㄙㄉㄗㄐ
走過咖啡屋=ㄗㄍㄎㄈㄨ
屋頂=ㄨㄉ
陳芳語劉德熙陳語嫣李紫婷吳映香=ㄔㄈㄩㄌㄉㄒㄔㄩㄧㄌㄗㄊㄨㄧㄒ
忘不掉=ㄨㄅㄉ
不用去猜=ㄅㄩㄑㄘ
牛奶咖啡=ㄋㄋㄎㄈ
世界第一名=ㄕㄐㄉㄧㄇ
一起老去=ㄧㄑㄌㄑ
奇蹟=ㄑㄐ
你快樂所以我快樂=ㄋㄎㄌㄙㄧㄨㄎㄌ
逆戰=ㄋㄓ
把你藏起來=ㄅㄋㄘㄑㄌ
囂張(純伴奏)=ㄒㄓ(ㄔㄅㄗ)
生存法則=ㄕㄘㄈㄗ
謝霆鋒游鴻明黃大煒黃中原=ㄒㄊㄈㄧㄏㄇㄏㄉㄨㄏㄓㄩ
吻別(純伴奏)=ㄨㄅ(ㄔㄅㄗ)
迪麗熱巴,毛不易=ㄉㄌㄖㄅ,ㄇㄅㄧ
悲傷的茱麗葉=ㄅㄕㄉㄓㄌㄧ
你會在哪呢=ㄋㄏㄗㄋㄋ
只要為你活一天=ㄓㄧㄨㄋㄏㄧㄊ
心疼=ㄒㄊ
一千個晚安=ㄧㄑㄍㄨㄢ
曲婉婷=ㄑㄨㄊ
斷魂淚=ㄉㄏㄌ
初夏的房間=ㄔㄒㄉㄈㄐ
傲嬌=ㄠㄐ
好好愛=ㄏㄏㄞ
掌紋=ㄓㄨ
女孩你為何踮腳尖(純伴奏)=ㄋㄏㄋㄨㄏㄉㄐㄐ(ㄔㄅㄗ)
至少還有你(純伴奏)=ㄓㄕㄏㄧㄋ(ㄔㄅㄗ)
求婚=ㄑㄏ
月兒彎彎照九州=ㄩㄦㄨㄨㄓㄐㄓ
相信自己=ㄒㄒㄗㄐ
光榮時刻=ㄍㄖㄕㄎ
南征北戰=ㄋㄓㄅㄓ
情人=ㄑㄖ
蔡小虎,龍千玉=ㄘㄒㄏ,ㄌㄑㄩ
彼卡皮箱=ㄅㄎㄆㄒ
墨水筆與橡皮擦=ㄇㄕㄅㄩㄒㄆㄘ
勝過這世界=ㄕㄍㄓㄕㄐ
非你不愛=ㄈㄋㄅㄞ
秋天不回來(純伴奏)=ㄑㄊㄅㄏㄌ(ㄔㄅㄗ)
張清芳,張宇=ㄓㄑㄈ,ㄓㄩ
放火=ㄈㄏ
把心留住=ㄅㄒㄌㄓ
晚安歌(純伴奏)=ㄨㄢㄍ(ㄔㄅㄗ)
印地安老斑鳩=ㄧㄉㄢㄌㄅㄐ
從前=ㄘㄑ
五百=ㄨㄅ
了解=ㄌㄐ
謝安琪=ㄒㄢㄑ
馬頔=ㄇ頔
迪克牛仔=ㄉㄎㄋㄗ
末日鬧鐘=ㄇㄖㄋㄓ
施文彬=ㄕㄨㄅ
黃韻玲=ㄏㄩㄌ
愛你的兩個我=ㄞㄋㄉㄌㄍㄨ
白日=ㄅㄖ
曾淑勤=ㄘㄕㄑ
惡名昭彰=ㄜㄇㄓㄓ
最後的風度=ㄗㄏㄉㄈㄉ
心動拍拍=ㄒㄉㄆㄆ
我帶你回家=ㄨㄉㄋㄏㄐ
青蘋果樂園(純伴奏)=ㄑㄆㄍㄌㄩ(ㄔㄅㄗ)
金思頓的夢想(純伴奏)=ㄐㄙㄉㄉㄇㄒ(ㄔㄅㄗ)
張韶涵=ㄓㄕㄏ
真實=ㄓㄕ
不該=ㄅㄍ
明天=ㄇㄊ
慶幸有你愛我=ㄑㄒㄧㄋㄞㄨ
華麗的冒險=ㄏㄌㄉㄇㄒ
靚仔=ㄐㄗ
陳奕迅=ㄔㄧㄒ
願祢的國降臨=ㄩㄋㄉㄍㄐㄌ
皇后區的皇后=ㄏㄏㄑㄉㄏㄏ
酒後的心聲=ㄐㄏㄉㄒㄕ
凌晨三點鐘=ㄌㄔㄙㄉㄓ
倉木麻衣=ㄘㄇㄇㄧ
陳怡婷蔡佳麟=ㄔㄧㄊㄘㄐㄌ
哭不出來=ㄎㄅㄔㄌ
余帝=ㄩㄉ
男性苦戀(純伴奏)=ㄋㄒㄎㄌ(ㄔㄅㄗ)
盧巧音=ㄌㄑㄧ
敢傷=ㄍㄕ
勝戰=ㄕㄓ
台北直直撞=ㄊㄅㄓㄓㄔ
一張批=ㄧㄓㄆ
第二人生=ㄉㄦㄖㄕ
永邦=ㄩㄅ
如果你是假的=ㄖㄍㄋㄕㄐㄉ
突然好想你=ㄊㄖㄏㄒㄋ
辣妹駕到=ㄌㄇㄐㄉ
病變=ㄅㄅ
答案=ㄉㄢ
張三的歌=ㄓㄙㄉㄍ
一路向北=ㄧㄌㄒㄅ
泥娃娃(純伴奏)=ㄋㄨㄨ(ㄔㄅㄗ)
最後一次(純伴奏)=ㄗㄏㄧㄘ(ㄔㄅㄗ)
不能再愛你=ㄅㄋㄗㄞㄋ
杜忻恬=ㄉㄒㄊ
茫霧之戀(純伴奏)=ㄇㄨㄓㄌ(ㄔㄅㄗ)
驚天動地=ㄐㄊㄉㄉ
七朵花=ㄑㄉㄏ
愛在身邊=ㄞㄗㄕㄅ
像我這樣的人(純伴奏)=ㄒㄨㄓㄧㄉㄖ(ㄔㄅㄗ)
新戀情=ㄒㄌㄑ
安苡葳=ㄢㄧㄨ
討厭夏天=ㄊㄧㄒㄊ
好的晚安=ㄏㄉㄨㄢ
別再驚動愛情=ㄅㄗㄐㄉㄞㄑ
我不想念=ㄨㄅㄒㄋ
男子漢=ㄋㄗㄏ
旅行的意義(純伴奏)=ㄌㄒㄉㄧㄧ(ㄔㄅㄗ)
你是我心中一句驚嘆=ㄋㄕㄨㄒㄓㄧㄐㄐㄊ
我沒有騙你(純伴奏)=ㄨㄇㄧㄆㄋ(ㄔㄅㄗ)
很久以後=ㄏㄐㄧㄏ
林佳蓉許淑絹=ㄌㄐㄖㄒㄕㄐ
小幸運=ㄒㄒㄩ
晚安地球人=ㄨㄢㄉㄑㄖ
我不知我愛你=ㄨㄅㄓㄨㄞㄋ
假如(純伴奏)=ㄐㄖ(ㄔㄅㄗ)
月亮代表誰的心=ㄩㄌㄉㄅㄕㄉㄒ
有影美(純伴奏)=ㄧㄧㄇ(ㄔㄅㄗ)
我還記得=ㄨㄏㄐㄉ
反背=ㄈㄅ
胡鴻鈞=ㄏㄏㄐ
家家酒(純伴奏)=ㄐㄐㄐ(ㄔㄅㄗ)
光澤=ㄍㄗ
處處吻(純伴奏)=ㄔㄔㄨ(ㄔㄅㄗ)
夏婉安=ㄒㄨㄢ
愛情傀儡=ㄞㄑㄎㄌ
你怎麼連話都說不清楚=ㄋㄗㄇㄌㄏㄉㄕㄅㄑㄔ
我愛過你=ㄨㄞㄍㄋ
三吋日光=ㄙㄘㄖㄍ
背叛無所謂=ㄅㄆㄨㄙㄨ
誰來海邊=ㄕㄌㄏㄅ
盛曉玫=ㄕㄒㄇ
呂方=ㄌㄈ
完整=ㄨㄓ
當我們宅一塊=ㄉㄨㄇㄓㄧㄎ
薩頂頂=ㄙㄉㄉ
雪花=ㄒㄏ
擊敗人=ㄐㄅㄖ
特別的人聲學=ㄊㄅㄉㄖㄕㄒ
非日常狂歡(純伴奏)=ㄈㄖㄔㄎㄏ(ㄔㄅㄗ)
給夢想一雙翅膀=ㄍㄇㄒㄧㄕㄔㄅ
他們說=ㄊㄇㄕ
浪子心聲=ㄌㄗㄒㄕ
哇沙米(純伴奏)=ㄨㄕㄇ(ㄔㄅㄗ)
我得你=ㄨㄉㄋ
愛情你比我想的閣較偉大(純伴奏)=ㄞㄑㄋㄅㄨㄒㄉㄍㄐㄨㄉ(ㄔㄅㄗ)
放生(純伴奏)=ㄈㄕ(ㄔㄅㄗ)
愛在=ㄞㄗ
閃亮的日子=ㄕㄌㄉㄖㄗ
張洪量莫文蔚=ㄓㄏㄌㄇㄨㄨ
風小箏=ㄈㄒㄓ
無你就無我(純伴奏)=ㄨㄋㄐㄨㄨ(ㄔㄅㄗ)
壞天氣=ㄏㄊㄑ
過火(純伴奏)=ㄍㄏ(ㄔㄅㄗ)
柯有倫=ㄎㄧㄌ
自由地歌唱=ㄗㄧㄉㄍㄔ
陳粒=ㄔㄌ
專注=ㄓㄓ
飄雪=ㄆㄒ
我敢=ㄨㄍ
遲到=ㄔㄉ
小李飛刀(純伴奏)=ㄒㄌㄈㄉ(ㄔㄅㄗ)
知足(純伴奏)=ㄓㄗ(ㄔㄅㄗ)
盧巧音王力宏=ㄌㄑㄧㄨㄌㄏ
送君情淚=ㄙㄐㄑㄌ
雨樱花=ㄩㄧㄏ
轉身之後=ㄓㄕㄓㄏ
熱愛(純伴奏)=ㄖㄞ(ㄔㄅㄗ)
大夥騎=ㄉㄏㄑ
我愛雨夜花=ㄨㄞㄩㄧㄏ
兩秒終=ㄌㄇㄓ
孤單的城市=ㄍㄉㄉㄔㄕ
妳並不像我想的那樣愛我=ㄋㄅㄅㄒㄨㄒㄉㄋㄧㄞㄨ
喬幼,楊哲=ㄑㄧ,ㄧㄓ
人生親像扮電影=ㄖㄕㄑㄒㄅㄉㄧ
美麗的神話=ㄇㄌㄉㄕㄏ
我是如此相信(純伴奏)=ㄨㄕㄖㄘㄒㄒ(ㄔㄅㄗ)
天下無雙=ㄊㄒㄨㄕ
紙雲煙=ㄓㄩㄧ
草屯囝仔,臭屁嬰仔=ㄘㄊㄋㄗ,ㄔㄆㄧㄗ
火山=ㄏㄕ
臭小孩=ㄔㄒㄏ
好春宵(純伴奏)=ㄏㄔㄒ(ㄔㄅㄗ)
潘裕文徐宛鈴=ㄆㄩㄨㄒㄨㄌ
上癮(純伴奏)=ㄕㄧ(ㄔㄅㄗ)
不過問=ㄅㄍㄨ
愛了很久的朋友(純伴奏)=ㄞㄌㄏㄐㄉㄆㄧ(ㄔㄅㄗ)
林隆璇張芸京=ㄌㄌㄒㄓㄩㄐ
頭號甜心=ㄊㄏㄊㄒ
我是真的付出我的愛=ㄨㄕㄓㄉㄈㄔㄨㄉㄞ
品冠,梁靜茹=ㄆㄍ,ㄌㄐㄖ
不滅=ㄅㄇ
知足=ㄓㄗ
與你同行=ㄩㄋㄊㄒ
看不見的星星=ㄎㄅㄐㄉㄒㄒ
昨夜星辰=ㄗㄧㄒㄔ
相見恨晚=ㄒㄐㄏㄨ
春日記憶=ㄔㄖㄐㄧ
冤氣=ㄩㄑ
黃金甲=ㄏㄐㄐ
完美孤獨=ㄨㄇㄍㄉ
煩=ㄈ
千里之外=ㄑㄌㄓㄨ
美味的想念=ㄇㄨㄉㄒㄋ
月彎彎(純伴奏)=ㄩㄨㄨ(ㄔㄅㄗ)
你也有今天=ㄋㄧㄧㄐㄊ
林采欣=ㄌㄘㄒ
感情核心=ㄍㄑㄏㄒ
高爾宣=ㄍㄦㄒ
我懷念的=ㄨㄏㄋㄉ
感同身受=ㄍㄊㄕㄕ
多事的秋=ㄉㄕㄉㄑ
山丘=ㄕㄑ
野子=ㄧㄗ
極速=ㄐㄙ
獨唱情歌=ㄉㄔㄑㄍ
舞女=ㄨㄋ
特別的人=ㄊㄅㄉㄖ
孤單探戈=ㄍㄉㄊㄍ
官靈芝=ㄍㄌㄓ
井上麻里奈=ㄐㄕㄇㄌㄋ
情關=ㄑㄍ
月光迪斯可=ㄩㄍㄉㄙㄎ
錯到底=ㄘㄉㄉ
憂傷來襲=ㄧㄕㄌㄒ
不僅僅是喜歡=ㄅㄐㄐㄕㄒㄏ
當初應該愛你=ㄉㄔㄧㄍㄞㄋ
堅強的女人=ㄐㄑㄉㄋㄖ
地下鐵=ㄉㄒㄊ
放大鏡=ㄈㄉㄐ
優客李林=ㄧㄎㄌㄌ
生日快樂=ㄕㄖㄎㄌ
戀戀真言=ㄌㄌㄓㄧ
塞納河=ㄙㄋㄏ
平日快樂=ㄆㄖㄎㄌ
沈以誠,薛明媛=ㄔㄧㄔ,ㄒㄇㄩ
月彎彎=ㄩㄨㄨ
時間都去哪兒了(純伴奏)=ㄕㄐㄉㄑㄋㄦㄌ(ㄔㄅㄗ)
經過一些秋與冬=ㄐㄍㄧㄒㄑㄩㄉ
恨不相逢未嫁時(純伴奏)=ㄏㄅㄒㄈㄨㄐㄕ(ㄔㄅㄗ)
爸爸媽媽=ㄅㄅㄇㄇ
林良樂=ㄌㄌㄌ
你以為=ㄋㄧㄨ
文章=ㄨㄓ
風花雪月=ㄈㄏㄒㄩ
一路順風=ㄧㄌㄕㄈ
城裡的月光=ㄔㄌㄉㄩㄍ
新樂塵符=ㄒㄌㄔㄈ
李麗芬=ㄌㄌㄈ
冷雨夜(純伴奏)=ㄌㄩㄧ(ㄔㄅㄗ)
依賴=ㄧㄌ
狀元=ㄓㄩ
奔向彩虹=ㄅㄒㄘㄏ
暗戀=ㄢㄌ
如果可以=ㄖㄍㄎㄧ
但願人長久=ㄉㄩㄖㄔㄐ
關淑怡=ㄍㄕㄧ
日頭客=ㄖㄊㄎ
你不公平=ㄋㄅㄍㄆ
不是因為天氣晴朗才愛你=ㄅㄕㄧㄨㄊㄑㄑㄌㄘㄞㄋ
吳克群=ㄨㄎㄑ
向左走向右走=ㄒㄗㄗㄒㄧㄗ
想說=ㄒㄕ
萬眾矚目=ㄨㄓㄓㄇ
你的眼睛背叛你的心=ㄋㄉㄧㄐㄅㄆㄋㄉㄒ
我們不一樣(純伴奏)=ㄨㄇㄅㄧㄧ(ㄔㄅㄗ)
三行情詩(純伴奏)=ㄙㄏㄑㄕ(ㄔㄅㄗ)
尹未來=ㄧㄨㄌ
魔鬼中的天使=ㄇㄍㄓㄉㄊㄕ
難得幸福=ㄋㄉㄒㄈ
妳的溫柔=ㄋㄉㄨㄖ
台北今夜冷清清=ㄊㄅㄐㄧㄌㄑㄑ
一個人=ㄧㄍㄖ
傷心童話(純伴奏)=ㄕㄒㄊㄏ(ㄔㄅㄗ)
方雅賢=ㄈㄧㄒ
蘇振華=ㄙㄓㄏ
羅時豐,王瑞霞,陳亞蘭=ㄌㄕㄈ,ㄨㄖㄒ,ㄔㄧㄌ
一起去巴黎=ㄧㄑㄑㄅㄌ
漁唱=ㄩㄔ
第一眼=ㄉㄧㄧ
明天會更好(純伴奏)=ㄇㄊㄏㄍㄏ(ㄔㄅㄗ)
電話皇后=ㄉㄏㄏㄏ
深信不疑=ㄕㄒㄅㄧ
冬眠(純伴奏)=ㄉㄇ(ㄔㄅㄗ)
下一站天后=ㄒㄧㄓㄊㄏ
三明治女孩=ㄙㄇㄓㄋㄏ
軌道=ㄍㄉ
洪榮宏,江蕙=ㄏㄖㄏ,ㄐㄏ
我們的明天=ㄨㄇㄉㄇㄊ
安全地帶=ㄢㄑㄉㄉ
車站=ㄔㄓ
阿爸父=ㄚㄅㄈ
今宵多珍重(純伴奏)=ㄐㄒㄉㄓㄓ(ㄔㄅㄗ)
生長(純伴奏)=ㄕㄓ(ㄔㄅㄗ)
賴來賴去=ㄌㄌㄌㄑ
癡情孤戀花=ㄔㄑㄍㄌㄏ
緣盡情未了=ㄩㄐㄑㄨㄌ
愛不對人=ㄞㄅㄉㄖ
一起飆高音=ㄧㄑㄅㄍㄧ
一萬個捨不得=ㄧㄨㄍㄕㄅㄉ
天翻地覆=ㄊㄈㄉㄈ
蝴蝶夢(純伴奏)=ㄏㄉㄇ(ㄔㄅㄗ)
暖暖的小時光=ㄋㄋㄉㄒㄕㄍ
乾啦乾啦=ㄍㄌㄍㄌ
試著了解=ㄕㄓㄌㄐ
沒有你的明天=ㄇㄧㄋㄉㄇㄊ
翁立友,黃思婷=ㄨㄌㄧ,ㄏㄙㄊ
末日之戀=ㄇㄖㄓㄌ
北酒場=ㄅㄐㄔ
卡門(純伴奏)=ㄎㄇ(ㄔㄅㄗ)
韓安旭=ㄏㄢㄒ
曠野寄情=ㄎㄧㄐㄑ
替我照顧她=ㄊㄨㄓㄍㄊ
手中玫瑰花=ㄕㄓㄇㄍㄏ
前前前世=ㄑㄑㄑㄕ
欣然丫=ㄒㄖㄧ
當愛變成習慣=ㄉㄞㄅㄔㄒㄍ
心甘情願=ㄒㄍㄑㄩ
你不愛我=ㄋㄅㄞㄨ
王識賢,孫淑媚=ㄨㄕㄒ,ㄙㄕㄇ
珊瑚島=ㄕㄏㄉ
溫嵐,周杰倫=ㄨㄌ,ㄓㄐㄌ
我是歌手=ㄨㄕㄍㄕ
刀郎=ㄉㄌ
說一句我不走了=ㄕㄧㄐㄨㄅㄗㄌ
姨仔=ㄧㄗ
作陣彼一暝=ㄗㄓㄅㄧㄇ
橋幸夫=ㄑㄒㄈ
男人的汗=ㄋㄖㄉㄏ
谷村新司=ㄍㄘㄒㄙ
我只想在乎我在乎的=ㄨㄓㄒㄗㄏㄨㄗㄏㄉ
如果能幸福=ㄖㄍㄋㄒㄈ
親愛的你怎麼不在身邊=ㄑㄞㄉㄋㄗㄇㄅㄗㄕㄅ
于台煙梁弘志=ㄩㄊㄧㄌㄏㄓ
快遞甜心=ㄎㄉㄊㄒ
我的依賴=ㄨㄉㄧㄌ
陳信宏=ㄔㄒㄏ
我比誰都清楚=ㄨㄅㄕㄉㄑㄔ
連詩雅=ㄌㄕㄧ
如果的事(純伴奏)=ㄖㄍㄉㄕ(ㄔㄅㄗ)
菊花台=ㄐㄏㄊ
不夠成熟(純伴奏)=ㄅㄍㄔㄕ(ㄔㄅㄗ)
祝你一路順風=ㄓㄋㄧㄌㄕㄈ
人阿=ㄖㄚ
桃花源=ㄊㄏㄩ
愛上屬於你的天空=ㄞㄕㄕㄩㄋㄉㄊㄎ
脫胎換骨=ㄊㄊㄏㄍ
今山古道=ㄐㄕㄍㄉ
我多麼羨慕你=ㄨㄉㄇㄒㄇㄋ
不再猶豫(純伴奏)=ㄅㄗㄧㄩ(ㄔㄅㄗ)
家後=ㄐㄏ
牽引=ㄑㄧ
風中的早晨=ㄈㄓㄉㄗㄔ
聽雪=ㄊㄒ
丁衣凡=ㄉㄧㄈ
大杉久美子=ㄉㄕㄐㄇㄗ
尋找=ㄒㄓ
找一個字代替=ㄓㄧㄍㄗㄉㄊ
思念來借過(純伴奏)=ㄙㄋㄌㄐㄍ(ㄔㄅㄗ)
堅定的心=ㄐㄉㄉㄒ
羅大佑,陳淑樺=ㄌㄉㄧ,ㄔㄕㄏ
人面桃花=ㄖㄇㄊㄏ
疼惜女人心=ㄊㄒㄋㄖㄒ
我喜歡私奔和我自己=ㄨㄒㄏㄙㄅㄏㄨㄗㄐ
如果雨之後(純伴奏)=ㄖㄍㄩㄓㄏ(ㄔㄅㄗ)
致姍姍來遲的你=ㄓㄕㄕㄌㄔㄉㄋ
風真透=ㄈㄓㄊ
張琍敏=ㄓㄌㄇ
為耶路撒冷祈禱=ㄨㄧㄌㄙㄌㄑㄉ
靠近一點點=ㄎㄐㄧㄉㄉ
假如你還在這裡=ㄐㄖㄋㄏㄗㄓㄌ
何以歌=ㄏㄧㄍ
練習愛情=ㄌㄒㄞㄑ
寶島曼波(純伴奏)=ㄅㄉㄇㄆ(ㄔㄅㄗ)
聽說愛情回來過=ㄊㄕㄞㄑㄏㄌㄍ
降下祢聖靈=ㄐㄒㄋㄕㄌ
奔向未來日子(純伴奏)=ㄅㄒㄨㄌㄖㄗ(ㄔㄅㄗ)
亂了陣腳=ㄌㄌㄓㄐ
孤獨探戈=ㄍㄉㄊㄍ
箱子=ㄒㄗ
永恆唯一的盼望=ㄩㄏㄨㄧㄉㄆㄨ
一隻小豬=ㄧㄓㄒㄓ
分手在最愛你的時候=ㄈㄕㄗㄗㄞㄋㄉㄕㄏ
放手一搏=ㄈㄕㄧㄅ
歐若拉(純伴奏)=ㄡㄖㄌ(ㄔㄅㄗ)
朋友(純伴奏)=ㄆㄧ(ㄔㄅㄗ)
芭比=ㄅㄅ
從未到過的地方=ㄘㄨㄉㄍㄉㄉㄈ
深夜的=ㄕㄧㄉ
浪人情歌=ㄌㄖㄑㄍ
新寶島康樂隊=ㄒㄅㄉㄎㄌㄉ
停不了的愛=ㄊㄅㄌㄉㄞ
釘子花=ㄉㄗㄏ
我只在乎你=ㄨㄓㄗㄏㄋ
火燒的寂寞=ㄏㄕㄉㄐㄇ
女人的眼淚=ㄋㄖㄉㄧㄌ
又是黃昏=ㄧㄕㄏㄏ
幸福的寄望(純伴奏)=ㄒㄈㄉㄐㄨ(ㄔㄅㄗ)
朱俐靜,畢書盡=ㄓㄌㄐ,ㄅㄕㄐ
寂寞暴走=ㄐㄇㄅㄗ
文慧如,呂國緯=ㄨㄏㄖ,ㄌㄍㄨ
斷線=ㄉㄒ
廖士賢=ㄌㄕㄒ
一曲相思=ㄧㄑㄒㄙ
神機會的風=ㄕㄐㄏㄉㄈ
沒落貴族=ㄇㄌㄍㄗ
歡喜就好=ㄏㄒㄐㄏ
防盜鎖=ㄈㄉㄙ
小薇=ㄒㄨ
邱勝翊=ㄑㄕㄧ
記得回來=ㄐㄉㄏㄌ
侵門踏戶=ㄑㄇㄊㄏ
愛上你只是我的錯=ㄞㄕㄋㄓㄕㄨㄉㄘ
顏志琳=ㄧㄓㄌ
腦袋逗啦(純伴奏)=ㄋㄉㄉㄌ(ㄔㄅㄗ)
懂還是不懂=ㄉㄏㄕㄅㄉ
紅顏劫(純伴奏)=ㄏㄧㄐ(ㄔㄅㄗ)
夏天的風(純伴奏)=ㄒㄊㄉㄈ(ㄔㄅㄗ)
補空夢=ㄅㄎㄇ
新不了情=ㄒㄅㄌㄑ
游鴻明=ㄧㄏㄇ
突然好想愛她=ㄊㄖㄏㄒㄞㄊ
現在就讓我走=ㄒㄗㄐㄖㄨㄗ
李嘉=ㄌㄐ
我家門前有大海=ㄨㄐㄇㄑㄧㄉㄏ
最後我們=ㄗㄏㄨㄇ
脫離=ㄊㄌ
燃燒吧！火鳥=ㄖㄕㄅ！ㄏㄋ
鹿晗=ㄌ晗
不僅僅是喜歡(純伴奏)=ㄅㄐㄐㄕㄒㄏ(ㄔㄅㄗ)
最好的樣子=ㄗㄏㄉㄧㄗ
泥娃娃=ㄋㄨㄨ
歐陽菲菲=ㄡㄧㄈㄈ
一生只有你=ㄧㄕㄓㄧㄋ
人生很難=ㄖㄕㄏㄋ
我的一生在祢手中=ㄨㄉㄧㄕㄗㄋㄕㄓ
不該(純伴奏)=ㄅㄍ(ㄔㄅㄗ)
劉艾立=ㄌㄞㄌ
放過自己(純伴奏)=ㄈㄍㄗㄐ(ㄔㄅㄗ)
不只是朋友=ㄅㄓㄕㄆㄧ
陪我喝一杯=ㄆㄨㄏㄧㄅ
往後餘生(純伴奏)=ㄨㄏㄩㄕ(ㄔㄅㄗ)
顏人中=ㄧㄖㄓ
圓謊=ㄩㄏ
把孤獨當作晚餐=ㄅㄍㄉㄉㄗㄨㄘ
傅又宣=ㄈㄧㄒ
歸屬感(純伴奏)=ㄍㄕㄍ(ㄔㄅㄗ)
可以勇敢可以溫柔=ㄎㄧㄩㄍㄎㄧㄨㄖ
洪百慧=ㄏㄅㄏ
生僻字=ㄕㄆㄗ
像瘋了一樣=ㄒㄈㄌㄧㄧ
後山癡情花=ㄏㄕㄔㄑㄏ
張瑋=ㄓㄨ
我們很好=ㄨㄇㄏㄏ
別勉強=ㄅㄇㄑ
林美秀=ㄌㄇㄒ
玖壹壹,黃路梓茵=ㄐㄧㄧ,ㄏㄌㄗㄧ
潘秀瓊=ㄆㄒㄑ
如果有如果=ㄖㄍㄧㄖㄍ
再見自己=ㄗㄐㄗㄐ
夜夜心疼=ㄧㄧㄒㄊ
最後一夜=ㄗㄏㄧㄧ
毒癮=ㄉㄧ
六個朋友=ㄌㄍㄆㄧ
月光=ㄩㄍ
追夢人(純伴奏)=ㄓㄇㄖ(ㄔㄅㄗ)
一生最愛的人=ㄧㄕㄗㄞㄉㄖ
致愛=ㄓㄞ
ê=ê
接下來是什麼=ㄐㄒㄌㄕㄕㄇ
月娘的眼淚=ㄩㄋㄉㄧㄌ
忘情水=ㄨㄑㄕ
最初的記憶(純伴奏)=ㄗㄔㄉㄐㄧ(ㄔㄅㄗ)
迷魂曲=ㄇㄏㄑ
心裡學=ㄒㄌㄒ
人生茶=ㄖㄕㄔ
兄妹情=ㄒㄇㄑ
好的事情=ㄏㄉㄕㄑ
觸電=ㄔㄉ
張學友=ㄓㄒㄧ
戀戀沙崙站=ㄌㄌㄕㄌㄓ
我的滑板鞋=ㄨㄉㄏㄅㄒ
天變地變情不變=ㄊㄅㄉㄅㄑㄅㄅ
五月天,張惠妹=ㄨㄩㄊ,ㄓㄏㄇ
夜空中最亮的星(純伴奏)=ㄧㄎㄓㄗㄌㄉㄒ(ㄔㄅㄗ)
前任(純伴奏)=ㄑㄖ(ㄔㄅㄗ)
忐忑=ㄊㄊ
好不好=ㄏㄅㄏ
月夜愁(純伴奏)=ㄩㄧㄔ(ㄔㄅㄗ)
迴=ㄏ
愛阮有多少=ㄞㄖㄧㄉㄕ
油桐花=ㄧㄊㄏ
欠阮的情債=ㄑㄖㄉㄑㄓ
天真=ㄊㄓ
特別的人精密=ㄊㄅㄉㄖㄐㄇ
獨家記憶=ㄉㄐㄐㄧ
如果沒有你(純伴奏)=ㄖㄍㄇㄧㄋ(ㄔㄅㄗ)
女性的哀怨(純伴奏)=ㄋㄒㄉㄞㄩ(ㄔㄅㄗ)
阿悠悠=ㄚㄧㄧ
大雪=ㄉㄒ
林志炫=ㄌㄓㄒ
飄香夢=ㄆㄒㄇ
愛的小路=ㄞㄉㄒㄌ
博多夜船=ㄅㄉㄧㄔ
凡人歌=ㄈㄖㄍ
失語者=ㄕㄩㄓ
再見我的愛人(純伴奏)=ㄗㄐㄨㄉㄞㄖ(ㄔㄅㄗ)
偷偷的愛=ㄊㄊㄉㄞ
為你流的淚=ㄨㄋㄌㄉㄌ
我期待=ㄨㄑㄉ
我想念我自己=ㄨㄒㄋㄨㄗㄐ
如果我是你=ㄖㄍㄨㄕㄋ
驕傲必敗=ㄐㄠㄅㄅ
傷心人傷心歌=ㄕㄒㄖㄕㄒㄍ
酷愛=ㄎㄞ
行=ㄒ
莎喲娜娜=ㄙㄧㄋㄋ
葉麗儀=ㄧㄌㄧ
苦酒滿杯=ㄎㄐㄇㄅ
那女孩對我說=ㄋㄋㄏㄉㄨㄕ
和自己賽跑的人=ㄏㄗㄐㄙㄆㄉㄖ
鄧子霆=ㄉㄗㄊ
屬於你和我之間的事=ㄕㄩㄋㄏㄨㄓㄐㄉㄕ
保存期限=ㄅㄘㄑㄒ
長江水=ㄔㄐㄕ
原來的我=ㄩㄌㄉㄨ
九月九的酒=ㄐㄩㄐㄉㄐ
夢中情人=ㄇㄓㄑㄖ
感恩的心=ㄍㄣㄉㄒ
來去台東=ㄌㄑㄊㄉ
半途而廢=ㄅㄊㄦㄈ
我的心里沒有他=ㄨㄉㄒㄌㄇㄧㄊ
十面埋伏(純伴奏)=ㄕㄇㄇㄈ(ㄔㄅㄗ)
他還是不懂=ㄊㄏㄕㄅㄉ
無人願愛我=ㄨㄖㄩㄞㄨ
外套=ㄨㄊ
命中注定=ㄇㄓㄓㄉ
無詞的歌=ㄨㄘㄉㄍ
不讀不回=ㄅㄉㄅㄏ
七郎=ㄑㄌ
金莎=ㄐㄙ
當我們混在一起=ㄉㄨㄇㄏㄗㄧㄑ
風起=ㄈㄑ
不够=ㄅㄍ
那片海(純伴奏)=ㄋㄆㄏ(ㄔㄅㄗ)
王錚亮=ㄨㄓㄌ
單眼皮女孩=ㄉㄧㄆㄋㄏ
長城=ㄔㄔ
一人=ㄧㄖ
金玟岐=ㄐㄨㄑ
陳隨意陳淑萍=ㄔㄙㄧㄔㄕㄆ
智商二五零=ㄓㄕㄦㄨㄌ
以後=ㄧㄏ
中國話=ㄓㄍㄏ
黃昏=ㄏㄏ
為愛而愛=ㄨㄞㄦㄞ
與祢同行=ㄩㄋㄊㄒ
接個吻，開一槍沈以誠薛明媛=ㄐㄍㄨ，ㄎㄧㄑㄔㄧㄔㄒㄇㄩ
鄭心慈=ㄓㄒㄘ
餘波盪漾=ㄩㄆㄉㄧ
我的未來式(純伴奏)=ㄨㄉㄨㄌㄕ(ㄔㄅㄗ)
張懸=ㄓㄒ
走在陽光裡=ㄗㄗㄧㄍㄌ
就要幸福了=ㄐㄧㄒㄈㄌ
愛的初體驗=ㄞㄉㄔㄊㄧ
惜別的海岸(純伴奏)=ㄒㄅㄉㄏㄢ(ㄔㄅㄗ)
吳鶯音=ㄨㄧㄧ
對你而言=ㄉㄋㄦㄧ
寂寞的季節(純伴奏)=ㄐㄇㄉㄐㄐ(ㄔㄅㄗ)
假面的告白=ㄐㄇㄉㄍㄅ
李聖傑,林隆璇=ㄌㄕㄐ,ㄌㄌㄒ
遠在眼前的你=ㄩㄗㄧㄑㄉㄋ
當我們一起走過(純伴奏)=ㄉㄨㄇㄧㄑㄗㄍ(ㄔㄅㄗ)
紀念日=ㄐㄋㄖ
耶穌=ㄧㄙ
薇多莉亞的秘密=ㄨㄉㄌㄧㄉㄇㄇ
張敬軒=ㄓㄐㄒ
正想著你呢(純伴奏)=ㄓㄒㄓㄋㄋ(ㄔㄅㄗ)
我可以=ㄨㄎㄧ
李壽全=ㄌㄕㄑ
日本娃娃=ㄖㄅㄨㄨ
紅豆湯=ㄏㄉㄊ
天天年輕(純伴奏)=ㄊㄊㄋㄑ(ㄔㄅㄗ)
心寒(純伴奏)=ㄒㄏ(ㄔㄅㄗ)
畫=ㄏ
不告而別=ㄅㄍㄦㄅ
暗戀你=ㄢㄌㄋ
伯父=ㄅㄈ
卓文萱=ㄓㄨㄒ
惜別夜港邊=ㄒㄅㄧㄍㄅ
羅文裕=ㄌㄨㄩ
宋昱錦=ㄙㄩㄐ
千古=ㄑㄍ
只看見妳=ㄓㄎㄐㄋ
幸福的滋味=ㄒㄈㄉㄗㄨ
忘情果(純伴奏)=ㄨㄑㄍ(ㄔㄅㄗ)
美麗女人(純伴奏)=ㄇㄌㄋㄖ(ㄔㄅㄗ)
洋蔥(純伴奏)=ㄧㄘ(ㄔㄅㄗ)
鬥陣的=ㄉㄓㄉ
我們都怕痛=ㄨㄇㄉㄆㄊ
忙著說再見=ㄇㄓㄕㄗㄐ
我好想你=ㄨㄏㄒㄋ
董小姐=ㄉㄒㄐ
想戀一個愛=ㄒㄌㄧㄍㄞ
失敗的高歌=ㄕㄅㄉㄍㄍ
心情=ㄒㄑ
卻上心頭(純伴奏)=ㄑㄕㄒㄊ(ㄔㄅㄗ)
紅顏舊(純伴奏)=ㄏㄧㄐ(ㄔㄅㄗ)
我愛你勝過你愛我=ㄨㄞㄋㄕㄍㄋㄞㄨ
有何不可=ㄧㄏㄅㄎ
風鈴聲(純伴奏)=ㄈㄌㄕ(ㄔㄅㄗ)
不醉不會=ㄅㄗㄅㄏ
翅膀(純伴奏)=ㄔㄅ(ㄔㄅㄗ)
賴雅妍=ㄌㄧㄧ
生而為贏(純伴奏)=ㄕㄦㄨㄧ(ㄔㄅㄗ)
浪漫來襲=ㄌㄇㄌㄒ
胡美紅=ㄏㄇㄏ
田村直美=ㄊㄘㄓㄇ
不藥而癒=ㄅㄧㄦㄩ
無聲的思念=ㄨㄕㄉㄙㄋ
替我照顧她(純伴奏)=ㄊㄨㄓㄍㄊ(ㄔㄅㄗ)
遠走高飛=ㄩㄗㄍㄈ
黃品源,莫文蔚=ㄏㄆㄩ,ㄇㄨㄨ
反正我信了=ㄈㄓㄨㄒㄌ
莊振凱,楊靜=ㄓㄓㄎ,ㄧㄐ
痴情花=ㄔㄑㄏ
可以唷=ㄎㄧㄧ
鳥籠=ㄋㄌ
花若離枝(純伴奏)=ㄏㄖㄌㄓ(ㄔㄅㄗ)
快有愛=ㄎㄧㄞ
簡上仁=ㄐㄕㄖ
卡通人生=ㄎㄊㄖㄕ
阿沁,李玖哲=ㄚㄑ,ㄌㄐㄓ
滅火器樂團=ㄇㄏㄑㄩㄊ
灰姑娘=ㄏㄍㄋ
帶我走(純伴奏)=ㄉㄨㄗ(ㄔㄅㄗ)
朴樹=ㄆㄕ
菊花台(純伴奏)=ㄐㄏㄊ(ㄔㄅㄗ)
楓=ㄈ
關山酒(純伴奏)=ㄍㄕㄐ(ㄔㄅㄗ)
破浪=ㄆㄌ
敢不敢(純伴奏)=ㄍㄅㄍ(ㄔㄅㄗ)
愛情之所以為愛情=ㄞㄑㄓㄙㄧㄨㄞㄑ
我好嗎=ㄨㄏㄇ
黃乙玲,郭桂彬=ㄏㄧㄌ,ㄍㄍㄅ
花僮=ㄏㄊ
沒那麼愛他=ㄇㄋㄇㄞㄊ
渣泥=ㄓㄋ
唯一的愛=ㄨㄧㄉㄞ
我只喜歡你=ㄨㄓㄒㄏㄋ
有話你就講啦=ㄧㄏㄋㄐㄐㄌ
龍捲風(純伴奏)=ㄌㄐㄈ(ㄔㄅㄗ)
緣字書(純伴奏)=ㄩㄗㄕ(ㄔㄅㄗ)
呂國緯=ㄌㄍㄨ
情難斷斷抹離=ㄑㄋㄉㄉㄇㄌ
君=ㄐ
戀歌=ㄌㄍ
家路=ㄐㄌ
鞦韆=ㄑㄑ
再說一次,我愛你=ㄗㄕㄧㄘ,ㄨㄞㄋ
雨愛=ㄩㄞ
驚雷=ㄐㄌ
可樂就是力量=ㄎㄌㄐㄕㄌㄌ
黃文星,曾昱嘉=ㄏㄨㄒ,ㄘㄩㄐ
無限的日期=ㄨㄒㄉㄖㄑ
當我回家=ㄉㄨㄏㄐ
買榜=ㄇㄅ
!=!
動力火車=ㄉㄌㄏㄔ
酒國英雄=ㄐㄍㄧㄒ
拜訪春天=ㄅㄈㄔㄊ
回家=ㄏㄐ
心電心=ㄒㄉㄒ
黑色翅膀=ㄏㄙㄔㄅ
心在故鄉=ㄒㄗㄍㄒ
依靠=ㄧㄎ
愛是懷疑=ㄞㄕㄏㄧ
我依然是你的情人=ㄨㄧㄖㄕㄋㄉㄑㄖ
最想念的季節=ㄗㄒㄋㄉㄐㄐ
絕口不提愛你=ㄐㄎㄅㄊㄞㄋ
阿士匹靈=ㄚㄕㄆㄌ
星空左右=ㄒㄎㄗㄧ
煮飯=ㄓㄈ
酒國戀歌=ㄐㄍㄌㄍ
不願放你走(純伴奏)=ㄅㄩㄈㄋㄗ(ㄔㄅㄗ)
朱海君=ㄓㄏㄐ
香港戀情=ㄒㄍㄌㄑ
我的未來不是夢=ㄨㄉㄨㄌㄅㄕㄇ
范瑋琪,張韶涵=ㄈㄨㄑ,ㄓㄕㄏ
我可以很勇敢=ㄨㄎㄧㄏㄩㄍ
寫不完的溫柔=ㄒㄅㄨㄉㄨㄖ
魂是英雄錢是膽=ㄏㄕㄧㄒㄑㄕㄉ
第二順位=ㄉㄦㄕㄨ
若你真的有想過=ㄖㄋㄓㄉㄧㄒㄍ
他不愛我=ㄊㄅㄞㄨ
芳華絕代=ㄈㄏㄐㄉ
王源=ㄨㄩ
花兒樂隊=ㄏㄦㄩㄉ
和平=ㄏㄆ
謝娜=ㄒㄋ
獨善其身=ㄉㄕㄑㄕ
一個人挺好=ㄧㄍㄖㄊㄏ
路嘉欣=ㄌㄐㄒ
林憶蓮=ㄌㄧㄌ
大魚(純伴奏)=ㄉㄩ(ㄔㄅㄗ)
陳明韶=ㄔㄇㄕ
那個男人=ㄋㄍㄋㄖ
敘酒=ㄒㄐ
背叛=ㄅㄆ
余天=ㄩㄊ
拜拜拜=ㄅㄅㄅ
有伴=ㄧㄅ
我只想唱歌=ㄨㄓㄒㄔㄍ
白牡丹=ㄅㄇㄉ
和你在一起=ㄏㄋㄗㄧㄑ
醉英雄=ㄗㄧㄒ
第一次愛的人=ㄉㄧㄘㄞㄉㄖ
邱振哲=ㄑㄓㄓ
廖文強=ㄌㄨㄑ
趙傳=ㄓㄔ
暫時的愛=ㄓㄕㄉㄞ
梨山痴情花(純伴奏)=ㄌㄕㄔㄑㄏ(ㄔㄅㄗ)
紅顏花=ㄏㄧㄏ
熱舞=ㄖㄨ
狂野之城=ㄎㄧㄓㄔ
親愛的那不是愛情(純伴奏)=ㄑㄞㄉㄋㄅㄕㄞㄑ(ㄔㄅㄗ)
黃韻玲,黃珊珊,張瑞薰,許景淳=ㄏㄩㄌ,ㄏㄕㄕ,ㄓㄖㄒ,ㄒㄐㄔ
野薑花的回憶=ㄧㄐㄏㄉㄏㄧ
愛你剛剛好=ㄞㄋㄍㄍㄏ
龍捲風=ㄌㄐㄈ
朱海君,吳俊宏=ㄓㄏㄐ,ㄨㄐㄏ
小旺福=ㄒㄨㄈ
成長的短髮=ㄔㄓㄉㄉㄈ
勿忘心安=ㄨㄨㄒㄢ
玖壹壹,陳嘉樺=ㄐㄧㄧ,ㄔㄐㄏ
動力火車,閻奕格=ㄉㄌㄏㄔ,ㄧㄧㄍ
卡路里=ㄎㄌㄌ
在水一方=ㄗㄕㄧㄈ
感情傘=ㄍㄑㄙ
陶喆,=ㄊㄓ,
成龍,李宗盛,周華健,黃耀明=ㄔㄌ,ㄌㄗㄕ,ㄓㄏㄐ,ㄏㄧㄇ
真心才有好結果=ㄓㄒㄘㄧㄏㄐㄍ
堅持的愛=ㄐㄔㄉㄞ
黃乙玲=ㄏㄧㄌ
無緣=ㄨㄩ
陸虎=ㄌㄏ
千分之一=ㄑㄈㄓㄧ
不死心還在=ㄅㄙㄒㄏㄗ
來互相傷害=ㄌㄏㄒㄕㄏ
加樂福尼亞=ㄐㄌㄈㄋㄧ
背水一戰=ㄅㄕㄧㄓ
小雨打在我身上=ㄒㄩㄉㄗㄨㄕㄕ
兩個人的回憶一個人過(純伴奏)=ㄌㄍㄖㄉㄏㄧㄧㄍㄖㄍ(ㄔㄅㄗ)
走在冷風中=ㄗㄗㄌㄈㄓ
龍千玉,楊哲=ㄌㄑㄩ,ㄧㄓ
誰(純伴奏)=ㄕ(ㄔㄅㄗ)
奇奇怪怪=ㄑㄑㄍㄍ
追心肝=ㄓㄒㄍ
周華健,李宗盛,品冠=ㄓㄏㄐ,ㄌㄗㄕ,ㄆㄍ
為何夢見他=ㄨㄏㄇㄐㄊ
你怕誰=ㄋㄆㄕ
暖暖(純伴奏)=ㄋㄋ(ㄔㄅㄗ)
楊靜,莊振凱=ㄧㄐ,ㄓㄓㄎ
陳慧琳,鄭中基=ㄔㄏㄌ,ㄓㄓㄐ
愛你的人=ㄞㄋㄉㄖ
下雨了=ㄒㄩㄌ
宥勝=ㄧㄕ
放過自己=ㄈㄍㄗㄐ
撥接=ㄅㄐ
最佳損友=ㄗㄐㄙㄧ
心裡有針=ㄒㄌㄧㄓ
岑寧兒=ㄘㄋㄦ
未央歌=ㄨㄧㄍ
流轉=ㄌㄓ
喜歡你怎麼辦=ㄒㄏㄋㄗㄇㄅ
凍結=ㄉㄐ
芳華絕代(純伴奏)=ㄈㄏㄐㄉ(ㄔㄅㄗ)
請你麥擱卡=ㄑㄋㄇㄍㄎ
有頭無尾=ㄧㄊㄨㄨ
張震嶽=ㄓㄓㄩ
葉啟田=ㄧㄑㄊ
邱鋒澤,黃偉晉=ㄑㄈㄗ,ㄏㄨㄐ
本田美奈子=ㄅㄊㄇㄋㄗ
愛･無卡紙(純伴奏)=ㄞ･ㄨㄎㄓ(ㄔㄅㄗ)
第一滴淚=ㄉㄧㄉㄌ
江青蓉=ㄐㄑㄖ
可惜愛=ㄎㄒㄞ
不將就=ㄅㄐㄐ
孔蘭薰=ㄎㄌㄒ
等等=ㄉㄉ
農村無代誌=ㄋㄘㄨㄉㄓ
恨情歌=ㄏㄑㄍ
綸彥霖=ㄌㄧㄌ
勇敢=ㄩㄍ
靈魂盡頭=ㄌㄏㄐㄊ
獵(純伴奏)=ㄌ(ㄔㄅㄗ)
世界最美的風景=ㄕㄐㄗㄇㄉㄈㄐ
秀蘭瑪雅=ㄒㄌㄇㄧ
香蕉人=ㄒㄐㄖ
謝博安=ㄒㄅㄢ
小田和正=ㄒㄊㄏㄓ
多餘的我=ㄉㄩㄉㄨ
在你身邊=ㄗㄋㄕㄅ
野蠻=ㄧㄇ
年輪說=ㄋㄌㄕ
句號(純伴奏)=ㄐㄏ(ㄔㄅㄗ)
陳明=ㄔㄇ
狂風裡擁抱(純伴奏)=ㄎㄈㄌㄩㄅ(ㄔㄅㄗ)
夜玫瑰=ㄧㄇㄍ
車窗上的雨=ㄔㄔㄕㄉㄩ
舊愛還是最美(純伴奏)=ㄐㄞㄏㄕㄗㄇ(ㄔㄅㄗ)
風再起時=ㄈㄗㄑㄕ
冷暴力=ㄌㄅㄌ
不變的應許=ㄅㄅㄉㄧㄒ
微笑帶過=ㄨㄒㄉㄍ
日光=ㄖㄍ
身體健康=ㄕㄊㄐㄎ
鴨子(純伴奏)=ㄧㄗ(ㄔㄅㄗ)
她愛了我好久=ㄊㄞㄌㄨㄏㄐ
痛愛=ㄊㄞ
一個人還是想著一個人(純伴奏)=ㄧㄍㄖㄏㄕㄒㄓㄧㄍㄖ(ㄔㄅㄗ)
軟心肝=ㄖㄒㄍ
風箏=ㄈㄓ
再愛一遍=ㄗㄞㄧㄅ
新靈糧詩選=ㄒㄌㄌㄕㄒ
寂寞難耐=ㄐㄇㄋㄋ
男人的好=ㄋㄖㄉㄏ
隔壁老樊=ㄍㄅㄌㄈ
雙截棍=ㄕㄐㄍ
摩托車=ㄇㄊㄔ
在雨中=ㄗㄩㄓ
我心已許=ㄨㄒㄧㄒ
痴情夢=ㄔㄑㄇ
庭院深深=ㄊㄩㄕㄕ
渴=ㄎ
男兒漂泊的心情=ㄋㄦㄆㄅㄉㄒㄑ
愛什麼稀罕=ㄞㄕㄇㄒㄏ
來鬧的=ㄌㄋㄉ
夢袜醒=ㄇㄨㄒ
我還年輕(純伴奏)=ㄨㄏㄋㄑ(ㄔㄅㄗ)
李俊毅=ㄌㄐㄧ
蔡黃汝=ㄘㄏㄖ
黑白=ㄏㄅ
曾經心痛=ㄘㄐㄒㄊ
雷雨心=ㄌㄩㄒ
平凡天使=ㄆㄈㄊㄕ
羅美玲=ㄌㄇㄌ
故鄉普悠瑪=ㄍㄒㄆㄧㄇ
全世煌=ㄑㄕㄏ
滴妹=ㄉㄇ
天外天=ㄊㄨㄊ
鞭炮=ㄅㄆ
心不在=ㄒㄅㄗ
扛得住=ㄎㄉㄓ
藍心羽=ㄌㄒㄩ
裘海正=ㄑㄏㄓ
野百合也有春天=ㄧㄅㄏㄧㄧㄔㄊ
無神論=ㄨㄕㄌ
我等到花兒也謝了(純伴奏)=ㄨㄉㄉㄏㄦㄧㄒㄌ(ㄔㄅㄗ)
命運青紅燈(純伴奏)=ㄇㄩㄑㄏㄉ(ㄔㄅㄗ)
小蘋果=ㄒㄆㄍ
子曰=ㄗㄩ
南方二重唱=ㄋㄈㄦㄔㄔ
終於結束的起點=ㄓㄩㄐㄕㄉㄑㄉ
赤血長殷=ㄔㄒㄔㄧ
你把愛情還給我=ㄋㄅㄞㄑㄏㄍㄨ
愛其實很殘忍=ㄞㄑㄕㄏㄘㄖ
王力宏,任家萱=ㄨㄌㄏ,ㄖㄐㄒ
城市少女=ㄔㄕㄕㄋ
你不在=ㄋㄅㄗ
雨水一盒=ㄩㄕㄧㄏ
寒星=ㄏㄒ
黃明志,李佳薇=ㄏㄇㄓ,ㄌㄐㄨ
折疊式愛情=ㄓㄉㄕㄞㄑ
至少還有你=ㄓㄕㄏㄧㄋ
薛凱琪=ㄒㄎㄑ
情歌王=ㄑㄍㄨ
山頂的春天=ㄕㄉㄉㄔㄊ
愛情恰恰(純伴奏)=ㄞㄑㄑㄑ(ㄔㄅㄗ)
傷心淚=ㄕㄒㄌ
車=ㄔ
忘詞=ㄨㄘ
王心凌=ㄨㄒㄌ
女人的勇氣=ㄋㄖㄉㄩㄑ
多麼想念你=ㄉㄇㄒㄋㄋ
平凡之路(純伴奏)=ㄆㄈㄓㄌ(ㄔㄅㄗ)
魚仔(純伴奏)=ㄩㄗ(ㄔㄅㄗ)
演員(純伴奏)=ㄧㄩ(ㄔㄅㄗ)
哇沙米=ㄨㄕㄇ
童話=ㄊㄏ
少女的祈禱=ㄕㄋㄉㄑㄉ
片片楓葉片片情(純伴奏)=ㄆㄆㄈㄧㄆㄆㄑ(ㄔㄅㄗ)
唱不完的副歌=ㄔㄅㄨㄉㄈㄍ
遠方=ㄩㄈ
無情人請你離開=ㄨㄑㄖㄑㄋㄌㄎ
不要亂說=ㄅㄧㄌㄕ
愛又愛=ㄞㄧㄞ
如煙=ㄖㄧ
兄弟(純伴奏)=ㄒㄉ(ㄔㄅㄗ)
賀一航(中國大陸男歌手)=ㄏㄧㄏ(ㄓㄍㄉㄌㄋㄍㄕ)
寫一首歌=ㄒㄧㄕㄍ
留不住的故事=ㄌㄅㄓㄉㄍㄕ
毀類=ㄏㄌ
冰雨(純伴奏)=ㄅㄩ(ㄔㄅㄗ)
渡我不渡她=ㄉㄨㄅㄉㄊ
爸爸(純伴奏)=ㄅㄅ(ㄔㄅㄗ)
遺失的國度=ㄧㄕㄉㄍㄉ
回心轉意=ㄏㄒㄓㄧ
漂著=ㄆㄓ
什麼都不必說=ㄕㄇㄉㄅㄅㄕ
不安=ㄅㄢ
光之翼=ㄍㄓㄧ
離歌=ㄌㄍ
有理想=ㄧㄌㄒ
古月照今塵=ㄍㄩㄓㄐㄔ
放手去愛(純伴奏)=ㄈㄕㄑㄞ(ㄔㄅㄗ)
聊傷=ㄌㄕ
她沒在看我(純伴奏)=ㄊㄇㄗㄎㄨ(ㄔㄅㄗ)
旅笠道中=ㄌㄌㄉㄓ
等著你回來=ㄉㄓㄋㄏㄌ
戴愛玲,小沃=ㄉㄞㄌ,ㄒㄨ
座位(純伴奏)=ㄗㄨ(ㄔㄅㄗ)
五百(純伴奏)=ㄨㄅ(ㄔㄅㄗ)
雨樱花(純伴奏)=ㄩㄧㄏ(ㄔㄅㄗ)
嚴爵=ㄧㄐ
不屑(純伴奏)=ㄅㄒ(ㄔㄅㄗ)
迷些路=ㄇㄒㄌ
五月雪=ㄨㄩㄒ
只怕想家=ㄓㄆㄒㄐ
對了錯了=ㄉㄌㄘㄌ
吳宗憲馮瑋君=ㄨㄗㄒㄈㄨㄐ
魔幻力量=ㄇㄏㄌㄌ
太坦白(純伴奏)=ㄊㄊㄅ(ㄔㄅㄗ)
第三杯酒(純伴奏)=ㄉㄙㄅㄐ(ㄔㄅㄗ)
橄欖樹=ㄍㄌㄕ
采蘑菇的小姑娘=ㄘㄇㄍㄉㄒㄍㄋ
一場遊戲一場夢=ㄧㄔㄧㄒㄧㄔㄇ
我想你不是真心愛我=ㄨㄒㄋㄅㄕㄓㄒㄞㄨ
想太多=ㄒㄊㄉ
李千那,王大文=ㄌㄑㄋ,ㄨㄉㄨ
我心已許(純伴奏)=ㄨㄒㄧㄒ(ㄔㄅㄗ)
花若離枝=ㄏㄖㄌㄓ
嘉賓(純伴奏)=ㄐㄅ(ㄔㄅㄗ)
搖搖搖=ㄧㄧㄧ
葉佳修=ㄧㄐㄒ
往事=ㄨㄕ
鍾漢良=ㄓㄏㄌ
愛珍惜=ㄞㄓㄒ
淚的小雨(純伴奏)=ㄌㄉㄒㄩ(ㄔㄅㄗ)
不想=ㄅㄒ
今生只為你(純伴奏)=ㄐㄕㄓㄨㄋ(ㄔㄅㄗ)
成全=ㄔㄑ
片尾曲=ㄆㄨㄑ
歌聲戀情=ㄍㄕㄌㄑ
甜美生活=ㄊㄇㄕㄏ
石敢當=ㄕㄍㄉ
(愛你)=(ㄞㄋ)
問酒(純伴奏)=ㄨㄐ(ㄔㄅㄗ)
什麼樣的愛=ㄕㄇㄧㄉㄞ
現在，你在哪裡？=ㄒㄗ，ㄋㄗㄋㄌ？
第九月台=ㄉㄐㄩㄊ
草地老阿伯=ㄘㄉㄌㄚㄅ
希望=ㄒㄨ
台灣製造=ㄊㄨㄓㄗ
請你給我好一點的情敵=ㄑㄋㄍㄨㄏㄧㄉㄉㄑㄉ
他還認不認得我=ㄊㄏㄖㄅㄖㄉㄨ
我是一隻畫眉鳥=ㄨㄕㄧㄓㄏㄇㄋ
愛到夏天=ㄞㄉㄒㄊ
藍雨=ㄌㄩ
我的口湧出美詞=ㄨㄉㄎㄩㄔㄇㄘ
戴愛玲,黃妃=ㄉㄞㄌ,ㄏㄈ
最近比較煩=ㄗㄐㄅㄐㄈ
露莎蘭=ㄌㄙㄌ
澎湖戀歌(純伴奏)=ㄆㄏㄌㄍ(ㄔㄅㄗ)
八三夭,周湯豪=ㄅㄙㄧ,ㄓㄊㄏ
夢妳在三更=ㄇㄋㄗㄙㄐ
愛的主旋律=ㄞㄉㄓㄒㄌ
阿牛=ㄚㄋ
多想愛你=ㄉㄒㄞㄋ
野菊花=ㄧㄐㄏ
交代(純伴奏)=ㄐㄉ(ㄔㄅㄗ)
愛愈深心愈凝=ㄞㄩㄕㄒㄩㄋ
裙擺搖搖=ㄑㄅㄧㄧ
陳淑萍林俊吉=ㄔㄕㄆㄌㄐㄐ
最後的溫柔=ㄗㄏㄉㄨㄖ
已經恁夜欸=ㄧㄐㄖㄧㄞ
剛好遇見你(純伴奏)=ㄍㄏㄩㄐㄋ(ㄔㄅㄗ)
江美琪光良=ㄐㄇㄑㄍㄌ
最難忘一天=ㄗㄋㄨㄧㄊ
你為什麼說謊(純伴奏)=ㄋㄨㄕㄇㄕㄏ(ㄔㄅㄗ)
阿肆=ㄚㄙ
宇宙人=ㄩㄓㄖ
親密愛人=ㄑㄇㄞㄖ
炎亞綸=ㄧㄧㄌ
鋼鐵人=ㄍㄊㄖ
關鍵詞=ㄍㄐㄘ
忘川=ㄨㄔ
忘記你我做不到(純伴奏)=ㄨㄐㄋㄨㄗㄅㄉ(ㄔㄅㄗ)
泡沫=ㄆㄇ
我跟你卡好(純伴奏)=ㄨㄍㄋㄎㄏ(ㄔㄅㄗ)
李友廷=ㄌㄧㄊ
酒海=ㄐㄏ
你很愛他=ㄋㄏㄞㄊ
半邊月=ㄅㄅㄩ
蔡家蓁=ㄘㄐㄓ
更寬的肩膀=ㄍㄎㄉㄐㄅ
不想懂得=ㄅㄒㄉㄉ
李玟=ㄌㄨ
單身女子俱樂部=ㄉㄕㄋㄗㄐㄌㄅ
夢然=ㄇㄖ
小手拉大手=ㄒㄕㄌㄉㄕ
一個人不可能=ㄧㄍㄖㄅㄎㄋ
魯冰花=ㄌㄅㄏ
以後別做朋友(純伴奏)=ㄧㄏㄅㄗㄆㄧ(ㄔㄅㄗ)
曾沛慈=ㄘㄆㄘ
你，好不好？=ㄋ，ㄏㄅㄏ？
派大星=ㄆㄉㄒ
三年的舊情(純伴奏)=ㄙㄋㄉㄐㄑ(ㄔㄅㄗ)
站在高崗上(純伴奏)=ㄓㄗㄍㄍㄕ(ㄔㄅㄗ)
大丈夫=ㄉㄓㄈ
月兒彎彎=ㄩㄦㄨㄨ
假裝我們沒愛過=ㄐㄓㄨㄇㄇㄞㄍ
綠色(純伴奏)=ㄌㄙ(ㄔㄅㄗ)
酷愛(純伴奏)=ㄎㄞ(ㄔㄅㄗ)
同在=ㄊㄗ
謝謝再聯絡=ㄒㄒㄗㄌㄌ
徐譽滕=ㄒㄩㄊ
丟了你=ㄉㄌㄋ
齊豫=ㄑㄩ
請你帶走=ㄑㄋㄉㄗ
笑忘書=ㄒㄨㄕ
愛與希望=ㄞㄩㄒㄨ
緣字書=ㄩㄗㄕ
當(純伴奏)=ㄉ(ㄔㄅㄗ)
永遠的快樂=ㄩㄩㄉㄎㄌ
今夜擱再想你=ㄐㄧㄍㄗㄒㄋ
唸歌給你聽=ㄋㄍㄍㄋㄊ
無人熟識=ㄨㄖㄕㄕ
這些花要送給你=ㄓㄒㄏㄧㄙㄍㄋ
愛殤(純伴奏)=ㄞㄕ(ㄔㄅㄗ)
蝸牛與黃鸝鳥=ㄍㄋㄩㄏㄌㄋ
樓梯間=ㄌㄊㄐ
天機=ㄊㄐ
李翊君=ㄌㄧㄐ
你被寫在我的歌裡=ㄋㄅㄒㄗㄨㄉㄍㄌ
木蘭=ㄇㄌ
借=ㄐ
不要再見面=ㄅㄧㄗㄐㄇ
一身紅=ㄧㄕㄏ
拿手絕活=ㄋㄕㄐㄏ
花心=ㄏㄒ
奇蹟(純伴奏)=ㄑㄐ(ㄔㄅㄗ)
芒果花=ㄇㄍㄏ
走馬燈的愛情=ㄗㄇㄉㄉㄞㄑ
愛情條約=ㄞㄑㄊㄩ
停格=ㄊㄍ
姐姐=ㄐㄐ
你甘攏袂不甘=ㄋㄍㄌㄇㄅㄍ
節日快樂=ㄐㄖㄎㄌ
運=ㄩ
說好的幸福呢(純伴奏)=ㄕㄏㄉㄒㄈㄋ(ㄔㄅㄗ)
陳柏霖=ㄔㄅㄌ
十秒的衝動=ㄕㄇㄉㄔㄉ
無所不在=ㄨㄙㄅㄗ
人生=ㄖㄕ
海海人生(純伴奏)=ㄏㄏㄖㄕ(ㄔㄅㄗ)
迷人的危險(純伴奏)=ㄇㄖㄉㄨㄒ(ㄔㄅㄗ)
分手快樂(純伴奏)=ㄈㄕㄎㄌ(ㄔㄅㄗ)
玫瑰少年=ㄇㄍㄕㄋ
去走走=ㄑㄗㄗ
方圓幾里(純伴奏)=ㄈㄩㄐㄌ(ㄔㄅㄗ)
嫦娥=ㄔㄜ
這是奇妙恩典=ㄓㄕㄑㄇㄣㄉ
醉人生=ㄗㄖㄕ
寂寞煙火=ㄐㄇㄧㄏ
水漣漪=ㄕㄌㄧ
愛是唯一=ㄞㄕㄨㄧ
不拖不欠=ㄅㄊㄅㄑ
半袖=ㄅㄒ
濁水溪岸=ㄓㄕㄒㄢ
小雨=ㄒㄩ
忍不住原諒=ㄖㄅㄓㄩㄌ
東西(純伴奏)=ㄉㄒ(ㄔㄅㄗ)
再說一次,我愛你(純伴奏)=ㄗㄕㄧㄘ,ㄨㄞㄋ(ㄔㄅㄗ)
我已經敢想你=ㄨㄧㄐㄍㄒㄋ
夜太黑=ㄧㄊㄏ
意難忘=ㄧㄋㄨ
是不是這樣=ㄕㄅㄕㄓㄧ
不應該勇敢(純伴奏)=ㄅㄧㄍㄩㄍ(ㄔㄅㄗ)
方大同=ㄈㄉㄊ
一個人歌=ㄧㄍㄖㄍ
看不見聽不見=ㄎㄅㄐㄊㄅㄐ
還是分開=ㄏㄕㄈㄎ
輕輕=ㄑㄑ
只為你唱=ㄓㄨㄋㄔ
熊仔豹子膽=ㄒㄗㄅㄗㄉ
無聊男孩=ㄨㄌㄋㄏ
月牙灣=ㄩㄧㄨ
王欣宇=ㄨㄒㄩ
莫文蔚=ㄇㄨㄨ
茉莉花=ㄇㄌㄏ
我只是你的愛人=ㄨㄓㄕㄋㄉㄞㄖ
開始愛=ㄎㄕㄞ
乘虛而入(純伴奏)=ㄔㄒㄦㄖ(ㄔㄅㄗ)
天窗=ㄊㄔ
五月天,李榮浩=ㄨㄩㄊ,ㄌㄖㄏ
另一種鄉愁=ㄌㄧㄓㄒㄔ
謝謝妳愛我=ㄒㄒㄋㄞㄨ
愛要坦蕩蕩=ㄞㄧㄊㄉㄉ
今天妳要嫁給我(純伴奏)=ㄐㄊㄋㄧㄐㄍㄨ(ㄔㄅㄗ)
擦肩而過=ㄘㄐㄦㄍ
十豆彡=ㄕㄉ彡
我好像在哪見過你(純伴奏)=ㄨㄏㄒㄗㄋㄐㄍㄋ(ㄔㄅㄗ)
陳零九邱鋒澤=ㄔㄌㄐㄑㄈㄗ
你的名=ㄋㄉㄇ
戀人啊=ㄌㄖㄚ
萊特姊弟=ㄌㄊㄐㄉ
客家人興發旺=ㄎㄐㄖㄒㄈㄨ
小橋流水=ㄒㄑㄌㄕ
謝和弦,瘦子=ㄒㄏㄒ,ㄕㄗ
一千遍我愛你(純伴奏)=ㄧㄑㄅㄨㄞㄋ(ㄔㄅㄗ)
小雀斑=ㄒㄑㄅ
注定相愛=ㄓㄉㄒㄞ
高橋洋子=ㄍㄑㄧㄗ
林嘉欣=ㄌㄐㄒ
有點甜(純伴奏)=ㄧㄉㄊ(ㄔㄅㄗ)
朱主愛=ㄓㄓㄞ
帶你去旅行(純伴奏)=ㄉㄋㄑㄌㄒ(ㄔㄅㄗ)
李玉剛=ㄌㄩㄍ
眼前人=ㄧㄑㄖ
永恆的印記=ㄩㄏㄉㄧㄐ
告白氣球=ㄍㄅㄑㄑ
誰人了解我(純伴奏)=ㄕㄖㄌㄐㄨ(ㄔㄅㄗ)
湯宇歆=ㄊㄩㄒ
說了再見以後=ㄕㄌㄗㄐㄧㄏ
一路上有你=ㄧㄌㄕㄧㄋ
超級市場=ㄔㄐㄕㄔ
你不是我的=ㄋㄅㄕㄨㄉ
戒情人=ㄐㄑㄖ
倉頡=ㄘㄐ
我愛的人(純伴奏)=ㄨㄞㄉㄖ(ㄔㄅㄗ)
黃立行=ㄏㄌㄒ
進行式=ㄐㄒㄕ
袁惟仁=ㄩㄨㄖ
心情歌路(純伴奏)=ㄒㄑㄍㄌ(ㄔㄅㄗ)
等我變了之後=ㄉㄨㄅㄌㄓㄏ
孤單淚=ㄍㄉㄌ
愛拼才會贏=ㄞㄆㄘㄏㄧ
被動=ㄅㄉ
許維芳謝嘉全=ㄒㄨㄈㄒㄐㄑ
劉旭陽=ㄌㄒㄧ
伯父(純伴奏)=ㄅㄈ(ㄔㄅㄗ)
偷故事的人=ㄊㄍㄕㄉㄖ
深情戀夢(純伴奏)=ㄕㄑㄌㄇ(ㄔㄅㄗ)
日出=ㄖㄔ
城裡的月光(純伴奏)=ㄔㄌㄉㄩㄍ(ㄔㄅㄗ)
山伯英台=ㄕㄅㄧㄊ
陳嘉樺=ㄔㄐㄏ
問酒=ㄨㄐ
想自由(純伴奏)=ㄒㄗㄧ(ㄔㄅㄗ)
口水流下來=ㄎㄕㄌㄒㄌ
你被寫在我的歌裡(純伴奏)=ㄋㄅㄒㄗㄨㄉㄍㄌ(ㄔㄅㄗ)
熊錦勝=ㄒㄐㄕ
表面的和平=ㄅㄇㄉㄏㄆ
中華之愛=ㄓㄏㄓㄞ
心酸=ㄒㄙ
鄧紫棋=ㄉㄗㄑ
洋蔥=ㄧㄘ
一生最愛你=ㄧㄕㄗㄞㄋ
南拳媽媽彈頭=ㄋㄑㄇㄇㄉㄊ
只有我的天空有烏雲=ㄓㄧㄨㄉㄊㄎㄧㄨㄩ
繁華攏是夢=ㄈㄏㄌㄕㄇ
陳昇=ㄔㄕ
理想家=ㄌㄒㄐ
基隆山之戀=ㄐㄌㄕㄓㄌ
動靜樂團=ㄉㄐㄩㄊ
積雨雲=ㄐㄩㄩ
米津玄師,菅田将暉=ㄇㄐㄒㄕ,ㄐㄊㄐㄏ
李珮菁=ㄌㄆㄐ
數到五答應我=ㄕㄉㄨㄉㄧㄨ
楊宗憲=ㄧㄗㄒ
為我好=ㄨㄨㄏ
葛林=ㄍㄌ
歷史的傷口=ㄌㄕㄉㄕㄎ
潛龍勿用=ㄑㄌㄨㄩ
北島詩=ㄅㄉㄕ
羅文=ㄌㄨ
玉霜=ㄩㄕ
人生要漂亮=ㄖㄕㄧㄆㄌ
亞特蘭提斯=ㄧㄊㄌㄊㄙ
林晏如=ㄌㄧㄖ
卓義峯=ㄓㄧ峯
獨處的時候=ㄉㄔㄉㄕㄏ
莊心妍=ㄓㄒㄧ
歐若拉=ㄡㄖㄌ
唇唇欲動=ㄔㄔㄩㄉ
,艾怡良,馬仕釗=,ㄞㄧㄌ,ㄇㄕㄓ
真愛=ㄓㄞ
在你背後=ㄗㄋㄅㄏ
可愛的查某=ㄎㄞㄉㄔㄇ
魏奇奇=ㄨㄑㄑ
你在我心中最深的地方=ㄋㄗㄨㄒㄓㄗㄕㄉㄉㄈ
懷念你媽媽=ㄏㄋㄋㄇㄇ
暝那會這呢長(純伴奏)=ㄇㄋㄏㄓㄋㄔ(ㄔㄅㄗ)
夢中恰恰=ㄇㄓㄑㄑ
月半小夜曲=ㄩㄅㄒㄧㄑ
我是一隻小小鳥(純伴奏)=ㄨㄕㄧㄓㄒㄒㄋ(ㄔㄅㄗ)
車站惜別=ㄔㄓㄒㄅ
星晴=ㄒㄑ
我要給世界最悠長的濕吻=ㄨㄧㄍㄕㄐㄗㄧㄔㄉㄕㄨ
目及皆是你=ㄇㄐㄐㄕㄋ
透明(純伴奏)=ㄊㄇ(ㄔㄅㄗ)
以馬內利=ㄧㄇㄋㄌ
親愛的樹洞=ㄑㄞㄉㄕㄉ
等待你返來=ㄉㄉㄋㄈㄌ
今生愛過的人(純伴奏)=ㄐㄕㄞㄍㄉㄖ(ㄔㄅㄗ)
失憶的金魚=ㄕㄧㄉㄐㄩ
心裡有樹=ㄒㄌㄧㄕ
陪著我的時候想著她=ㄆㄓㄨㄉㄕㄏㄒㄓㄊ
安靜了=ㄢㄐㄌ
回到過去=ㄏㄉㄍㄑ
呼求你憐憫=ㄏㄑㄋㄌㄇ
贏你喲=ㄧㄋㄧ
馬子狗=ㄇㄗㄍ
鬥牛舞(純伴奏)=ㄉㄋㄨ(ㄔㄅㄗ)
你怎麼說=ㄋㄗㄇㄕ
如果雨之後=ㄖㄍㄩㄓㄏ
真愛尺碼=ㄓㄞㄔㄇ
上愛的人=ㄕㄞㄉㄖ
可惜=ㄎㄒ
河邊春夢(純伴奏)=ㄏㄅㄔㄇ(ㄔㄅㄗ)
張雨生=ㄓㄩㄕ
孤獨為榮=ㄍㄉㄨㄖ
我不怕=ㄨㄅㄆ
仰望=ㄧㄨ
大美麗=ㄉㄇㄌ
段千尋=ㄉㄑㄒ
七天=ㄑㄊ
睡公主=ㄕㄍㄓ
新寵=ㄒㄔ
張文綺=ㄓㄨㄑ
Я=Я
誘惑的街=ㄧㄏㄉㄐ
流氓阿德=ㄌㄇㄚㄉ
小暑(純伴奏)=ㄒㄕ(ㄔㄅㄗ)
梁靜茹,盧廣仲=ㄌㄐㄖ,ㄌㄍㄓ
重來的力量=ㄔㄌㄉㄌㄌ
要我怎麼忘了他=ㄧㄨㄗㄇㄨㄌㄊ
劉若英,黃韻玲=ㄌㄖㄧ,ㄏㄩㄌ
情路無尾巷=ㄑㄌㄨㄨㄒ
早安晨之美=ㄗㄢㄔㄓㄇ
那一夜你喝了酒=ㄋㄧㄧㄋㄏㄌㄐ
睡在一起的知己=ㄕㄗㄧㄑㄉㄓㄐ
他一個人=ㄊㄧㄍㄖ
王夢麟=ㄨㄇㄌ
憨人碼頭=ㄏㄖㄇㄊ
馮曦妤=ㄈㄒㄩ
喬幼=ㄑㄧ
李玉璽=ㄌㄩㄒ
嫁妝=ㄐㄓ
白頭鬃=ㄅㄊㄗ
女人情=ㄋㄖㄑ
早應該=ㄗㄧㄍ
盛開=ㄕㄎ
晚安=ㄨㄢ
有一種愛叫等待=ㄧㄧㄓㄞㄐㄉㄉ
愛的供養=ㄞㄉㄍㄧ
不浪漫罪名=ㄅㄌㄇㄗㄇ
特別的人譜面=ㄊㄅㄉㄖㄆㄇ
知己=ㄓㄐ
愛一回傷一回=ㄞㄧㄏㄕㄧㄏ
討厭紅樓夢=ㄊㄧㄏㄌㄇ
莊淑君=ㄓㄕㄐ
自由之歌=ㄗㄧㄓㄍ
天星=ㄊㄒ
親愛的無情孫小美=ㄑㄞㄉㄨㄑㄙㄒㄇ
相思話=ㄒㄙㄏ
七上八下=ㄑㄕㄅㄒ
天黑黑=ㄊㄏㄏ
吳青峰,=ㄨㄑㄈ,
孫子兵法=ㄙㄗㄅㄈ
許紹洋=ㄒㄕㄧ
我跟你卡好=ㄨㄍㄋㄎㄏ
雪在燒=ㄒㄗㄕ
小丑=ㄒㄔ
陳冠霖=ㄔㄍㄌ
情人節快樂=ㄑㄖㄐㄎㄌ
碧海情天=ㄅㄏㄑㄊ
有心人(純伴奏)=ㄧㄒㄖ(ㄔㄅㄗ)
文夏=ㄨㄒ
全世界失眠=ㄑㄕㄐㄕㄇ
三生三世=ㄙㄕㄙㄕ
下一站=ㄒㄧㄓ
謝宇威=ㄒㄩㄨ
想死卻又不敢(純伴奏)=ㄒㄙㄑㄧㄅㄍ(ㄔㄅㄗ)
風中的承諾=ㄈㄓㄉㄔㄋ
好想愛這個世界啊=ㄏㄒㄞㄓㄍㄕㄐㄚ
辛曉琪=ㄒㄒㄑ
愛上你是一個錯=ㄞㄕㄋㄕㄧㄍㄘ
辛曉琪張國榮=ㄒㄒㄑㄓㄍㄖ
花浪=ㄏㄌ
不像個大人=ㄅㄒㄍㄉㄖ
房鈺玲蔡沂庭張懷庭廖宗筠=ㄈㄩㄌㄘㄧㄊㄓㄏㄊㄌㄗㄩ
走不回去的旅程=ㄗㄅㄏㄑㄉㄌㄔ
幹大事=ㄍㄉㄕ
答應不愛你=ㄉㄧㄅㄞㄋ
李玟,柯以敏=ㄌㄨ,ㄎㄧㄇ
舊衫櫥(純伴奏)=ㄐㄕㄔ(ㄔㄅㄗ)
聖結石聖嫂=ㄕㄐㄕㄕㄙ
再見煙火(純伴奏)=ㄗㄐㄧㄏ(ㄔㄅㄗ)
不愛請閃開=ㄅㄞㄑㄕㄎ
蕭亞軒,胡彥斌=ㄒㄧㄒ,ㄏㄧㄅ
無情的夜都市=ㄨㄑㄉㄧㄉㄕ
李佳薇=ㄌㄐㄨ
愛情衝衝衝=ㄞㄑㄔㄔㄔ
鄭進一=ㄓㄐㄧ
漂亮一下=ㄆㄌㄧㄒ
心肝子=ㄒㄍㄗ
你幹嘛=ㄋㄍㄇ
只想對你說=ㄓㄒㄉㄋㄕ
好的事情(純伴奏)=ㄏㄉㄕㄑ(ㄔㄅㄗ)
薄情愛=ㄅㄑㄞ
別惹哭我=ㄅㄖㄎㄨ
安可=ㄢㄎ
聖誕結(純伴奏)=ㄕㄉㄐ(ㄔㄅㄗ)
距離(純伴奏)=ㄐㄌ(ㄔㄅㄗ)
藍色貝殼=ㄌㄙㄅㄎ
醜人多作怪(純伴奏)=ㄔㄖㄉㄗㄍ(ㄔㄅㄗ)
情深深雨濛濛(純伴奏)=ㄑㄕㄕㄩㄇㄇ(ㄔㄅㄗ)
大雨=ㄉㄩ
我們呼求=ㄨㄇㄏㄑ
單數=ㄉㄕ
情字這條路=ㄑㄗㄓㄊㄌ
耶穌基督=ㄧㄙㄐㄉ
阿嬤=ㄚㄇ
下一次愛情來的時候=ㄒㄧㄘㄞㄑㄌㄉㄕㄏ
張清芳,李驥=ㄓㄑㄈ,ㄌㄐ
愛的天國=ㄞㄉㄊㄍ
看見快樂對我笑=ㄎㄐㄎㄌㄉㄨㄒ
一起開始的旅程=ㄧㄑㄎㄕㄉㄌㄔ
如果我變成一首歌=ㄖㄍㄨㄅㄔㄧㄕㄍ
真心換絕情=ㄓㄒㄏㄐㄑ
麥憨啊=ㄇㄏㄚ
活著屬於你=ㄏㄓㄕㄩㄋ
笑紅塵=ㄒㄏㄔ
我可以為你擋死=ㄨㄎㄧㄨㄋㄉㄙ
愛你愛你=ㄞㄋㄞㄋ
將天敞開=ㄐㄊㄔㄎ
蕭煌奇,曾寶儀=ㄒㄏㄑ,ㄗㄅㄧ
國王與乞丐=ㄍㄨㄩㄑㄍ
睫毛彎彎=ㄐㄇㄨㄨ
聽見下雨的聲音(純伴奏)=ㄊㄐㄒㄩㄉㄕㄧ(ㄔㄅㄗ)
無言花(純伴奏)=ㄨㄧㄏ(ㄔㄅㄗ)
看見復興=ㄎㄐㄈㄒ
陽光和小雨=ㄧㄍㄏㄒㄩ
家=ㄐ
我不知道愛是什麼=ㄨㄅㄓㄉㄞㄕㄕㄇ
難忘的初戀情人(純伴奏)=ㄋㄨㄉㄔㄌㄑㄖ(ㄔㄅㄗ)
失戀無罪=ㄕㄌㄨㄗ
,周思涵=,ㄓㄙㄏ
我不快樂=ㄨㄅㄎㄌ
今夜又擱想起你=ㄐㄧㄧㄍㄒㄑㄋ
自拍=ㄗㄆ
皮卡丘多多=ㄆㄎㄑㄉㄉ
給你們=ㄍㄋㄇ
蝴蝶夢=ㄏㄉㄇ
佛系少女=ㄈㄒㄕㄋ
勉為其難(純伴奏)=ㄇㄨㄑㄋ(ㄔㄅㄗ)
有誰共鳴(純伴奏)=ㄧㄕㄍㄇ(ㄔㄅㄗ)
無賴正義=ㄨㄌㄓㄧ
相忘=ㄒㄨ
文鶯=ㄨㄧ
好好愛我=ㄏㄏㄞㄨ
惜命命=ㄒㄇㄇ
不如沒問過=ㄅㄖㄇㄨㄍ
愛著愛著就永遠=ㄞㄓㄞㄓㄐㄩㄩ
我們沒有再見=ㄨㄇㄇㄧㄗㄐ
流浪者的獨白(純伴奏)=ㄌㄌㄓㄉㄉㄅ(ㄔㄅㄗ)
我在這=ㄨㄗㄓ
過去的=ㄍㄑㄉ
愛與痛的邊緣=ㄞㄩㄊㄉㄅㄩ
放逐愛情=ㄈㄓㄞㄑ
我喜歡你=ㄨㄒㄏㄋ
你的完美有點難懂並不代表世界不能包容=ㄋㄉㄨㄇㄧㄉㄋㄉㄅㄅㄉㄅㄕㄐㄅㄋㄅㄖ
范廣慧張智真=ㄈㄍㄏㄓㄓㄓ
偏見=ㄆㄐ
恩典夠用=ㄣㄉㄍㄩ
準備好了沒有=ㄓㄅㄏㄌㄇㄧ
妳聽得到=ㄋㄊㄉㄉ
十一年=ㄕㄧㄋ
袁小迪郭東聖=ㄩㄒㄉㄍㄉㄕ
閃靈樂團,何韻詩=ㄕㄌㄩㄊ,ㄏㄩㄕ
袁詠琳=ㄩㄩㄌ
感覺=ㄍㄐ
男兒的心情=ㄋㄦㄉㄒㄑ
對你有感覺=ㄉㄋㄧㄍㄐ
汽球=ㄑㄑ
我的幸福剛剛好=ㄨㄉㄒㄈㄍㄍㄏ
餘年=ㄩㄋ
虎二=ㄏㄦ
失去你阮要按怎活=ㄕㄑㄋㄖㄧㄢㄗㄏ
花樹下=ㄏㄕㄒ
煙花易冷=ㄧㄏㄧㄌ
別來無恙=ㄅㄌㄨㄧ
何日君再來=ㄏㄖㄐㄗㄌ
大寒=ㄉㄏ
陳百潭鳳娘=ㄔㄅㄊㄈㄋ
鄭中基,高慧君,陳曉東,蔡健雅=ㄓㄓㄐ,ㄍㄏㄐ,ㄔㄒㄉ,ㄘㄐㄧ
手機仔(一)=ㄕㄐㄗ(ㄧ)
幸福之戀=ㄒㄈㄓㄌ
我多麼想成為你的鹿=ㄨㄉㄇㄒㄔㄨㄋㄉㄌ
虞兮嘆(純伴奏)=ㄩㄒㄊ(ㄔㄅㄗ)
楊乃文=ㄧㄋㄨ
謝震廷=ㄒㄓㄊ
我想有個家(純伴奏)=ㄨㄒㄧㄍㄐ(ㄔㄅㄗ)
第一頁=ㄉㄧㄧ
陪伴阮身邊=ㄆㄅㄖㄕㄅ
愛到心痛=ㄞㄉㄒㄊ
周杰倫,陳信宏=ㄓㄐㄌ,ㄔㄒㄏ
,王=,ㄨ
分裂=ㄈㄌ
楓(純伴奏)=ㄈ(ㄔㄅㄗ)
由我們主宰=ㄧㄨㄇㄓㄗ
今天=ㄐㄊ
一定要相信自己=ㄧㄉㄧㄒㄒㄗㄐ
天頂的月娘(純伴奏)=ㄊㄉㄉㄩㄋ(ㄔㄅㄗ)
百年孤寂(純伴奏)=ㄅㄋㄍㄐ(ㄔㄅㄗ)
張秀卿,莊振凱=ㄓㄒㄑ,ㄓㄓㄎ
放愛一條生路=ㄈㄞㄧㄊㄕㄌ
爺爺=ㄧㄧ
寂寞無害=ㄐㄇㄨㄏ
深情海岸=ㄕㄑㄏㄢ
落花情=ㄌㄏㄑ
你約我在夏天見面=ㄋㄩㄨㄗㄒㄊㄐㄇ
平原綾香=ㄆㄩㄌㄒ
淡水暮色=ㄉㄕㄇㄙ
聽!是誰在唱歌?=ㄊ!ㄕㄕㄗㄔㄍ?
必為你們爭戰=ㄅㄨㄋㄇㄓㄓ
毛阿敏=ㄇㄚㄇ
裝睡的人=ㄓㄕㄉㄖ
斷了(純伴奏)=ㄉㄌ(ㄔㄅㄗ)
鄭茵聲=ㄓㄧㄕ
那些人那些事=ㄋㄒㄖㄋㄒㄕ
憨子=ㄏㄗ
巨人的肩膀=ㄐㄖㄉㄐㄅ
愛的魔法=ㄞㄉㄇㄈ
塘橋夜話=ㄊㄑㄧㄏ
愛在聖誕=ㄞㄗㄕㄉ
親愛的世界=ㄑㄞㄉㄕㄐ
袂慣習(純伴奏)=ㄇㄍㄒ(ㄔㄅㄗ)
胭脂味=ㄧㄓㄨ
那麼愛你為什麼(純伴奏)=ㄋㄇㄞㄋㄨㄕㄇ(ㄔㄅㄗ)
郭富城=ㄍㄈㄔ
鴛鴦夢醒=ㄩㄧㄇㄒ
面具=ㄇㄐ
卓文萱黃鴻升=ㄓㄨㄒㄏㄏㄕ
會讀書=ㄏㄉㄕ
美酒加咖啡=ㄇㄐㄐㄎㄈ
方季惟=ㄈㄐㄨ
往事就是我的安慰=ㄨㄕㄐㄕㄨㄉㄢㄨ
懺悔文=ㄔㄏㄨ
施文彬陳亞蘭=ㄕㄨㄅㄔㄧㄌ
以愛之名=ㄧㄞㄓㄇ
頭髮亂了=ㄊㄈㄌㄌ
前任=ㄑㄖ
我該得到=ㄨㄍㄉㄉ
大哥=ㄉㄍ
你的重要=ㄋㄉㄓㄧ
純情玫瑰花=ㄔㄑㄇㄍㄏ
可惜你不在=ㄎㄒㄋㄅㄗ
事後菸=ㄕㄏㄧ
劉若英,黃立行=ㄌㄖㄧ,ㄏㄌㄒ
八三夭,任賢齊,陳信宏=ㄅㄙㄧ,ㄖㄒㄑ,ㄔㄒㄏ
麻雀=ㄇㄑ
吃苦當作吃補=ㄔㄎㄉㄗㄔㄅ
良心=ㄌㄒ
盛夏=ㄕㄒ
假裝=ㄐㄓ
脫拉庫=ㄊㄌㄎ
開不了心=ㄎㄅㄌㄒ
我不離開=ㄨㄅㄌㄎ
許願(純伴奏)=ㄒㄩ(ㄔㄅㄗ)
胡宇威=ㄏㄩㄨ
說不出的告別=ㄕㄅㄔㄉㄍㄅ
如果能幸福(純伴奏)=ㄖㄍㄋㄒㄈ(ㄔㄅㄗ)
吳克群豬哥亮=ㄨㄎㄑㄓㄍㄌ
周二珂=ㄓㄦㄎ
蔡孟臻=ㄘㄇㄓ
我一個人記得就好=ㄨㄧㄍㄖㄐㄉㄐㄏ
禱告等候祢=ㄉㄍㄉㄏㄋ
英台(純伴奏)=ㄧㄊ(ㄔㄅㄗ)
小羊=ㄒㄧ
迷路在雲端=ㄇㄌㄗㄩㄉ
葉啟田,尤美=ㄧㄑㄊ,ㄧㄇ
歐拉拉呼呼=ㄡㄌㄌㄏㄏ
老師，斯卡也答=ㄌㄕ，ㄙㄎㄧㄉ
你的微笑=ㄋㄉㄨㄒ
往事只能回味=ㄨㄕㄓㄋㄏㄨ
陪我到以後=ㄆㄨㄉㄧㄏ
愛回航=ㄞㄏㄏ
林宥嘉=ㄌㄧㄐ
讓我一次愛個夠=ㄖㄨㄧㄘㄞㄍㄍ
雨季=ㄩㄐ
悲戀的公路=ㄅㄌㄉㄍㄌ
要不要買菜=ㄧㄅㄧㄇㄘ
有膽才敢大聲=ㄧㄉㄘㄍㄉㄕ
三八阿花吹喇叭=ㄙㄅㄚㄏㄔㄌㄅ
愛到最後=ㄞㄉㄗㄏ
加大力度=ㄐㄉㄌㄉ
我的世界沒有你的音準=ㄨㄉㄕㄐㄇㄧㄋㄉㄧㄓ
幾千公里=ㄐㄑㄍㄌ
奮鬥的歌手(純伴奏)=ㄈㄉㄉㄍㄕ(ㄔㄅㄗ)
包美聖=ㄅㄇㄕ
傳奇=ㄔㄑ
異類的同類=ㄧㄌㄉㄊㄌ
王新蓮馬宜中=ㄨㄒㄌㄇㄧㄓ
假惺惺=ㄐㄒㄒ
鄭興琦=ㄓㄒㄑ
謝謝你放我走=ㄒㄒㄋㄈㄨㄗ
思念的夢=ㄙㄋㄉㄇ
季節雨=ㄐㄐㄩ
說愛你=ㄕㄞㄋ
愛如雪=ㄞㄖㄒ
我們在愛中漫步=ㄨㄇㄗㄞㄓㄇㄅ
四堅情=ㄙㄐㄑ
譚詠麟=ㄊㄩㄌ
下次我會把你抓緊=ㄒㄘㄨㄏㄅㄋㄓㄐ
美麗的誤會=ㄇㄌㄉㄨㄏ
好想好好愛你=ㄏㄒㄏㄏㄞㄋ
女孩你為何踮腳尖=ㄋㄏㄋㄨㄏㄉㄐㄐ
情難斷夢抹醒=ㄑㄋㄉㄇㄇㄒ
不晚=ㄅㄨ
銀角仔=ㄧㄐㄗ
讓水倒流=ㄖㄕㄉㄌ
不值得=ㄅㄓㄉ
重口味=ㄓㄎㄨ
突然好想你(純伴奏)=ㄊㄖㄏㄒㄋ(ㄔㄅㄗ)
鑽石糖=ㄗㄕㄊ
鴛鴦溪(純伴奏)=ㄩㄧㄒ(ㄔㄅㄗ)
落大雨=ㄌㄉㄩ
孫雪寧=ㄙㄒㄋ
林京燁=ㄌㄐㄧ
失眠飛行(純伴奏)=ㄕㄇㄈㄒ(ㄔㄅㄗ)
孫語賽,蕭全=ㄙㄩㄙ,ㄒㄑ
火=ㄏ
鼓聲若響=ㄍㄕㄖㄒ
風醉雨也醉=ㄈㄗㄩㄧㄗ
月光愛人=ㄩㄍㄞㄖ
今夜又擱為你醉(純伴奏)=ㄐㄧㄧㄍㄨㄋㄗ(ㄔㄅㄗ)
默(純伴奏)=ㄇ(ㄔㄅㄗ)
莎賓娜=ㄙㄅㄋ
結束不是我要的結果(純伴奏)=ㄐㄕㄅㄕㄨㄧㄉㄐㄍ(ㄔㄅㄗ)
心動=ㄒㄉ
防不勝防=ㄈㄅㄕㄈ
司南=ㄙㄋ
分不到你的愛=ㄈㄅㄉㄋㄉㄞ
不換=ㄅㄏ
新垣結衣=ㄒㄩㄐㄧ
風吹風吹=ㄈㄔㄈㄔ
可愛的玫瑰花=ㄎㄞㄉㄇㄍㄏ
雨蝶=ㄩㄉ
分身有術(純伴奏)=ㄈㄕㄧㄕ(ㄔㄅㄗ)
忘情森巴舞=ㄨㄑㄙㄅㄨ
眼神=ㄧㄕ
你走你的路(純伴奏)=ㄋㄗㄋㄉㄌ(ㄔㄅㄗ)
趙之璧=ㄓㄓㄅ
丁噹,=ㄉㄉ,
流沙=ㄌㄕ
啞巴=ㄧㄅ
蕭秉治=ㄒㄅㄓ
沒有你的聖誕節=ㄇㄧㄋㄉㄕㄉㄐ
思相枝=ㄙㄒㄓ
鯨落=ㄐㄌ
高爾宣,陳忻玥=ㄍㄦㄒ,ㄔㄒㄩ
陷阱(純伴奏)=ㄒㄐ(ㄔㄅㄗ)
天光=ㄊㄍ
時代的女人=ㄕㄉㄉㄋㄖ
渾身是勁=ㄏㄕㄕㄐ
背叛情歌=ㄅㄆㄑㄍ
有沒有=ㄧㄇㄧ
在你和天空之間=ㄗㄋㄏㄊㄎㄓㄐ
不只是朋友(純伴奏)=ㄅㄓㄕㄆㄧ(ㄔㄅㄗ)
赤伶(純伴奏)=ㄔㄌ(ㄔㄅㄗ)
乾一杯(純伴奏)=ㄍㄧㄅ(ㄔㄅㄗ)
美麗的花=ㄇㄌㄉㄏ
帶你去旅行=ㄉㄋㄑㄌㄒ
水從天上來(純伴奏)=ㄕㄘㄊㄕㄌ(ㄔㄅㄗ)
小城大事=ㄒㄔㄉㄕ
一起喔喔=ㄧㄑㄨㄨ
熱線你和我=ㄖㄒㄋㄏㄨ
一直走=ㄧㄓㄗ
山茶花=ㄕㄔㄏ
幸福門=ㄒㄈㄇ
別問很可怕=ㄅㄨㄏㄎㄆ
夢一場(純伴奏)=ㄇㄧㄔ(ㄔㄅㄗ)
母系社會=ㄇㄒㄕㄏ
不需要知道=ㄅㄒㄧㄓㄉ
老王樂隊=ㄌㄨㄩㄉ
我心已打烊=ㄨㄒㄧㄉㄧ
我離開我自己=ㄨㄌㄎㄨㄗㄐ
春花夢露=ㄔㄏㄇㄌ
三寸天堂=ㄙㄘㄊㄊ
有誰來愛我=ㄧㄕㄌㄞㄨ
當我知道你們相愛=ㄉㄨㄓㄉㄋㄇㄒㄞ
煙花淚=ㄧㄏㄌ
歐漢聲=ㄡㄏㄕ
重生=ㄔㄕ
邱澤沈建宏=ㄑㄗㄔㄐㄏ
*=*
愛得起=ㄞㄉㄑ
尤雅=ㄧㄧ
追=ㄓ
小孩不懂怕=ㄒㄏㄅㄉㄆ
情深緣淺=ㄑㄕㄩㄑ
海闊天空=ㄏㄎㄊㄎ
董育君,鄔兆邦=ㄉㄩㄐ,ㄨㄓㄅ
立春=ㄌㄔ
林俊傑=ㄌㄐㄐ
陽光宅男=ㄧㄍㄓㄋ
滿足=ㄇㄗ
蘋果花(純伴奏)=ㄆㄍㄏ(ㄔㄅㄗ)
情長路更長=ㄑㄔㄌㄍㄔ
小孩(純伴奏)=ㄒㄏ(ㄔㄅㄗ)
簡單愛=ㄐㄉㄞ
理想情人(純伴奏)=ㄌㄒㄑㄖ(ㄔㄅㄗ)
吳宗憲=ㄨㄗㄒ
滾石眾歌手=ㄍㄕㄓㄍㄕ
河仁傑=ㄏㄖㄐ
再會呀港都=ㄗㄏㄧㄍㄉ
校長=ㄒㄓ
不按牌理出牌=ㄅㄢㄆㄌㄔㄆ
如果你快樂=ㄖㄍㄋㄎㄌ
命中註定我愛你=ㄇㄓㄓㄉㄨㄞㄋ
危險世界=ㄨㄒㄕㄐ
星之所向=ㄒㄓㄙㄒ
往未來飛的客機=ㄨㄨㄌㄈㄉㄎㄐ
行棋=ㄒㄑ
男人情女人心=ㄋㄖㄑㄋㄖㄒ
沒完沒了=ㄇㄨㄇㄌ
林為音=ㄌㄨㄧ
阿冗=ㄚㄖ
鍊愛=ㄌㄞ
翁立友,董育君=ㄨㄌㄧ,ㄉㄩㄐ
曾心梅,莊振凱=ㄘㄒㄇ,ㄓㄓㄎ
戴梅君=ㄉㄇㄐ
女人的願望=ㄋㄖㄉㄩㄨ
一個人的我依然會微笑=ㄧㄍㄖㄉㄨㄧㄖㄏㄨㄒ
我還年輕我還年輕=ㄨㄏㄋㄑㄨㄏㄋㄑ
祝你順風(純伴奏)=ㄓㄋㄕㄈ(ㄔㄅㄗ)
缺口譜面=ㄑㄎㄆㄇ
王菲=ㄨㄈ
失真=ㄕㄓ
遊山戀(純伴奏)=ㄧㄕㄌ(ㄔㄅㄗ)
淚崩了=ㄌㄅㄌ
生命河靈糧堂=ㄕㄇㄏㄌㄌㄊ
ñ=ñ
海浪=ㄏㄌ
寂寞的戀人啊=ㄐㄇㄉㄌㄖㄚ
嘻哈庄腳情=ㄒㄏㄓㄐㄑ
附心漢=ㄈㄒㄏ
相信愛(純伴奏)=ㄒㄒㄞ(ㄔㄅㄗ)
在銀色的月光下=ㄗㄧㄙㄉㄩㄍㄒ
好壞=ㄏㄏ
凝視=ㄋㄕ
第一百個我=ㄉㄧㄅㄍㄨ
情路放我過(純伴奏)=ㄑㄌㄈㄨㄍ(ㄔㄅㄗ)
江山美人=ㄐㄕㄇㄖ
只要有祢在我左右=ㄓㄧㄧㄋㄗㄨㄗㄧ
阿拉斯加海灣=ㄚㄌㄙㄐㄏㄨ
東風破(純伴奏)=ㄉㄈㄆ(ㄔㄅㄗ)
隔離(純伴奏)=ㄍㄌ(ㄔㄅㄗ)
不拖不欠(純伴奏)=ㄅㄊㄅㄑ(ㄔㄅㄗ)
放手去愛=ㄈㄕㄑㄞ
我是你的誰=ㄨㄕㄋㄉㄕ
三個傻瓜=ㄙㄍㄕㄍ
黃子軒與山平快滅火器楊大正=ㄏㄗㄒㄩㄕㄆㄎㄇㄏㄑㄧㄉㄓ
浪子回頭(純伴奏)=ㄌㄗㄏㄊ(ㄔㄅㄗ)
孤獨為榮(純伴奏)=ㄍㄉㄨㄖ(ㄔㄅㄗ)
手中情=ㄕㄓㄑ
初戀=ㄔㄌ
借問你=ㄐㄨㄋ
潘裕文=ㄆㄩㄨ
我敢夢=ㄨㄍㄇ
梅艷芳=ㄇㄧㄈ
不期而遇(純伴奏)=ㄅㄑㄦㄩ(ㄔㄅㄗ)
邱鋒澤,吳心緹=ㄑㄈㄗ,ㄨㄒㄊ
喜歡一個人=ㄒㄏㄧㄍㄖ
明天我們不見不散=ㄇㄊㄨㄇㄅㄐㄅㄙ
問相思=ㄨㄒㄙ
說謊=ㄕㄏ
紀露霞=ㄐㄌㄒ
綠島小夜曲=ㄌㄉㄒㄧㄑ
鼓聲若響(純伴奏)=ㄍㄕㄖㄒ(ㄔㄅㄗ)
咖啡一個人=ㄎㄈㄧㄍㄖ
看看=ㄎㄎ
幸福太短=ㄒㄈㄊㄉ
散場的擁抱=ㄙㄔㄉㄩㄅ
愛上未來的你=ㄞㄕㄨㄌㄉㄋ
每次醒來=ㄇㄘㄒㄌ
心頭鎖(純伴奏)=ㄒㄊㄙ(ㄔㄅㄗ)
恩典之流=ㄣㄉㄓㄌ
一起看月亮=ㄧㄑㄎㄩㄌ
正想著你呢=ㄓㄒㄓㄋㄋ
葉諾帆=ㄧㄋㄈ
我想我不會愛你=ㄨㄒㄨㄅㄏㄞㄋ
我相信=ㄨㄒㄒ
像霧又像花=ㄒㄨㄧㄒㄏ
不愛我就拉倒(純伴奏)=ㄅㄞㄨㄐㄌㄉ(ㄔㄅㄗ)
蜻蜓=ㄑㄊ
因為寂寞=ㄧㄨㄐㄇ
無情的夜都市(純伴奏)=ㄨㄑㄉㄧㄉㄕ(ㄔㄅㄗ)
西卿=ㄒㄑ
邵雨薇=ㄕㄩㄨ
五月天,張國璽=ㄨㄩㄊ,ㄓㄍㄒ
北極星的眼淚=ㄅㄐㄒㄉㄧㄌ
防火牆=ㄈㄏㄑ
迷途羔羊=ㄇㄊㄍㄧ
小酒窩=ㄒㄐㄨ
請你不通嫌棄我=ㄑㄋㄅㄊㄒㄑㄨ
其實很愛你=ㄑㄕㄏㄞㄋ
致青春=ㄓㄑㄔ
放下旅行=ㄈㄒㄌㄒ
分隔線=ㄈㄍㄒ
美女與野獸=ㄇㄋㄩㄧㄕ
睫毛彎彎(純伴奏)=ㄐㄇㄨㄨ(ㄔㄅㄗ)
讓我一次愛個夠(純伴奏)=ㄖㄨㄧㄘㄞㄍㄍ(ㄔㄅㄗ)
薛岳=ㄒㄩ
大驚小怪=ㄉㄐㄒㄍ
伍佰=ㄨㄅ
黑蝙蝠中隊=ㄏㄅㄈㄓㄉ
敗給你=ㄅㄍㄋ
高山低谷=ㄍㄕㄉㄍ
復興=ㄈㄒ
背對背擁抱=ㄅㄉㄅㄩㄅ
熱愛=ㄖㄞ
小姐!請妳乎我愛=ㄒㄐ!ㄑㄋㄏㄨㄞ
單身公害=ㄉㄕㄍㄏ
是不是這樣的夜晚你才會這樣的想起我=ㄕㄅㄕㄓㄧㄉㄧㄨㄋㄘㄏㄓㄧㄉㄒㄑㄨ
耶穌之名`=ㄧㄙㄓㄇ`
如果有一天=ㄖㄍㄧㄧㄊ
張秀卿,蔡小虎=ㄓㄒㄑ,ㄘㄒㄏ
拆信=ㄔㄒ
開水與白麵包=ㄎㄕㄩㄅㄇㄅ
奔向未來日子譜面=ㄅㄒㄨㄌㄖㄗㄆㄇ
把愛放開=ㄅㄞㄈㄎ
林凡=ㄌㄈ
黑框眼鏡=ㄏㄎㄧㄐ
心之火=ㄒㄓㄏ
小酒窩(粵語)=ㄒㄐㄨ(ㄩㄩ)
見招拆招=ㄐㄓㄔㄓ
:=:
花期(純伴奏)=ㄏㄑ(ㄔㄅㄗ)
本身的用處=ㄅㄕㄉㄩㄔ
蔡健雅=ㄘㄐㄧ
謝金晶=ㄒㄐㄐ
原來的你=ㄩㄌㄉㄋ
詩人漫步=ㄕㄖㄇㄅ
無關善良=ㄨㄍㄕㄌ
鏡蹤=ㄐㄗ
國度屬於祢=ㄍㄉㄕㄩㄋ
給自己的歌=ㄍㄗㄐㄉㄍ
平凡之路=ㄆㄈㄓㄌ
說不出我愛你=ㄕㄅㄔㄨㄞㄋ
我最愛的人就是你=ㄨㄗㄞㄉㄖㄐㄕㄋ
成龍=ㄔㄌ
米津玄師菅田将暉=ㄇㄐㄒㄕㄐㄊㄐㄏ
大藝術家=ㄉㄧㄕㄐ
十萬毫升淚水聲學=ㄕㄨㄏㄕㄌㄕㄕㄒ
有種(純伴奏)=ㄧㄓ(ㄔㄅㄗ)
謝天謝地=ㄒㄊㄒㄉ
愛情孤單行=ㄞㄑㄍㄉㄒ
問月娘=ㄨㄩㄋ
分手=ㄈㄕ
弘田三枝子=ㄏㄊㄙㄓㄗ
一直=ㄧㄓ
大眠(純伴奏)=ㄉㄇ(ㄔㄅㄗ)
熱淚暗班車=ㄖㄌㄢㄅㄔ
相逢夕陽下=ㄒㄈㄒㄧㄒ
沒那麼脆弱=ㄇㄋㄇㄘㄖ
青花瓷=ㄑㄏㄘ
林曉培=ㄌㄒㄆ
相依為命(純伴奏)=ㄒㄧㄨㄇ(ㄔㄅㄗ)
小寒=ㄒㄏ
亦帆=ㄧㄈ
不說再見=ㄅㄕㄗㄐ
我還想念你=ㄨㄏㄒㄋㄋ
禮物=ㄌㄨ
太委屈=ㄊㄨㄑ
差不多姑娘=ㄔㄅㄉㄍㄋ
順其自然=ㄕㄑㄗㄖ
猴籠=ㄏㄌ
妹妹要快樂=ㄇㄇㄧㄎㄌ
流淚谷=ㄌㄌㄍ
黑馬=ㄏㄇ
稻香(純伴奏)=ㄉㄒ(ㄔㄅㄗ)
林慧萍=ㄌㄏㄆ
不過失去了一點點=ㄅㄍㄕㄑㄌㄧㄉㄉ
腦公=ㄋㄍ
怕胖團=ㄆㄆㄊ
關不掉的月光=ㄍㄅㄉㄉㄩㄍ
夜蓮花=ㄧㄌㄏ
邱幸儀=ㄑㄒㄧ
可不可以你也剛好喜歡我=ㄎㄅㄎㄧㄋㄧㄍㄏㄒㄏㄨ
崇拜(純伴奏)=ㄔㄅ(ㄔㄅㄗ)
口袋的天空=ㄎㄉㄉㄊㄎ
幸福獵人=ㄒㄈㄌㄖ
媽媽你無對我講=ㄇㄇㄋㄨㄉㄨㄐ
林文隆=ㄌㄨㄌ
絕情路=ㄐㄑㄌ
龍的傳人=ㄌㄉㄔㄖ
你的背包=ㄋㄉㄅㄅ
可憐戀花再會吧=ㄎㄌㄌㄏㄗㄏㄅ
預告=ㄩㄍ
美麗的花蝴蝶=ㄇㄌㄉㄏㄏㄉ
徐若瑄,曹格=ㄒㄖㄒ,ㄘㄍ
愛得不要不要=ㄞㄉㄅㄧㄅㄧ
勁歌金曲=ㄐㄍㄐㄑ
無盡的港口=ㄨㄐㄉㄍㄎ
虞兮嘆=ㄩㄒㄊ
你們要讚美耶和華=ㄋㄇㄧㄗㄇㄧㄏㄏ
唐磊=ㄊㄌ
洛少爺落櫻風=ㄌㄕㄧㄌㄧㄈ
就值得了愛=ㄐㄓㄉㄌㄞ
虎頭埤之戀=ㄏㄊㄅㄓㄌ
可憐彼個小姑娘(純伴奏)=ㄎㄌㄅㄍㄒㄍㄋ(ㄔㄅㄗ)
願得一人心(純伴奏)=ㄩㄉㄧㄖㄒ(ㄔㄅㄗ)
漸暖(純伴奏)=ㄐㄋ(ㄔㄅㄗ)
未接來電=ㄨㄐㄌㄉ
陽帆,江蕙=ㄧㄈ,ㄐㄏ
過去的(純伴奏)=ㄍㄑㄉ(ㄔㄅㄗ)
不可說=ㄅㄎㄕ
神話=ㄕㄏ
瘋狂=ㄈㄎ
蘋果花=ㄆㄍㄏ
我能給的=ㄨㄋㄍㄉ
牆紙=ㄑㄓ
愛當香=ㄞㄉㄒ
李劍青=ㄌㄐㄑ
安妮=ㄢㄋ
真面目=ㄓㄇㄇ
三月裡的小雨=ㄙㄩㄌㄉㄒㄩ
愛情限時批=ㄞㄑㄒㄕㄆ
燈籠魚=ㄉㄌㄩ
你想娶我嗎=ㄋㄒㄑㄨㄇ
心門的廉子=ㄒㄇㄉㄌㄗ
兩隻老虎=ㄌㄓㄌㄏ
約書亞樂團=ㄩㄕㄧㄩㄊ
千千萬萬=ㄑㄑㄨㄨ
衛蘭=ㄨㄌ
親愛的你在哪裡=ㄑㄞㄉㄋㄗㄋㄌ
你就不要想起我=ㄋㄐㄅㄧㄒㄑㄨ
中等美女=ㄓㄉㄇㄋ
日本娃娃(純伴奏)=ㄖㄅㄨㄨ(ㄔㄅㄗ)
愛愛愛=ㄞㄞㄞ
痘痘那邊=ㄉㄉㄋㄅ
徐歌陽=ㄒㄍㄧ
陳零九,韋禮安=ㄔㄌㄐ,ㄨㄌㄢ
流行歌曲=ㄌㄒㄍㄑ
成功大學級=ㄔㄍㄉㄒㄐ
三人遊=ㄙㄖㄧ
不散的筵席=ㄅㄙㄉㄧㄒ
咖啡一個人(純伴奏)=ㄎㄈㄧㄍㄖ(ㄔㄅㄗ)
再遇見=ㄗㄩㄐ
男人=ㄋㄖ
今夜留一點愛給我=ㄐㄧㄌㄧㄉㄞㄍㄨ
運河悲喜曲=ㄩㄏㄅㄒㄑ
愛情離我一公尺=ㄞㄑㄌㄨㄧㄍㄔ
美麗女人=ㄇㄌㄋㄖ
當一個天使的憂愁=ㄉㄧㄍㄊㄕㄉㄧㄔ
愛情怎麼了嗎=ㄞㄑㄗㄇㄌㄇ
順子=ㄕㄗ
讓回憶隨風飄(純伴奏)=ㄖㄏㄧㄙㄈㄆ(ㄔㄅㄗ)
風中的玫瑰(純伴奏)=ㄈㄓㄉㄇㄍ(ㄔㄅㄗ)
再一次擁有(純伴奏)=ㄗㄧㄘㄩㄧ(ㄔㄅㄗ)
二三十=ㄦㄙㄕ
人海中遇見你=ㄖㄏㄓㄩㄐㄋ
受傷的心=ㄕㄕㄉㄒ
偶然=ㄡㄖ
誤點小站=ㄨㄉㄒㄓ
幸福額度=ㄒㄈㄜㄉ
思念的情淚(純伴奏)=ㄙㄋㄉㄑㄌ(ㄔㄅㄗ)
豆漿油條=ㄉㄐㄧㄊ
爭戰乃在乎神=ㄓㄓㄋㄗㄏㄕ
一生跟隨祢=ㄧㄕㄍㄙㄋ
愚人的國度=ㄩㄖㄉㄍㄉ
雨宗林=ㄩㄗㄌ
丁噹,呂國緯=ㄉㄉ,ㄌㄍㄨ
怪獸=ㄍㄕ
陳雪凝=ㄔㄒㄋ
一起去旅行=ㄧㄑㄑㄌㄒ
佚名=ㄧㄇ
主祢是我們的太陽,=ㄓㄋㄕㄨㄇㄉㄊㄧ,
蕭敬騰=ㄒㄐㄊ
別(純伴奏)=ㄅ(ㄔㄅㄗ)
早班火車=ㄗㄅㄏㄔ
插翅難飛=ㄔㄔㄋㄈ
慢慢說樂團=ㄇㄇㄕㄩㄊ
你的答案(純伴奏)=ㄋㄉㄉㄢ(ㄔㄅㄗ)
展展與羅羅=ㄓㄓㄩㄌㄌ
吳卓源,婁峻碩=ㄨㄓㄩ,ㄌㄐㄕ
我問天(純伴奏)=ㄨㄨㄊ(ㄔㄅㄗ)
許美靜=ㄒㄇㄐ
從一片落葉開始=ㄘㄧㄆㄌㄧㄎㄕ
我就是這種女孩(純伴奏)=ㄨㄐㄕㄓㄓㄋㄏ(ㄔㄅㄗ)
耶和華大能的軍隊=ㄧㄏㄏㄉㄋㄉㄐㄉ
浪漫血液=ㄌㄇㄒㄧ
大風吹=ㄉㄈㄔ
徐婕兒=ㄒㄐㄦ
四面楚歌=ㄙㄇㄔㄍ
盛夏的果實=ㄕㄒㄉㄍㄕ
可愛=ㄎㄞ
林為音林俊吉=ㄌㄨㄧㄌㄐㄐ
一萬個不回頭的方法=ㄧㄨㄍㄅㄏㄊㄉㄈㄈ
一言難盡=ㄧㄧㄋㄐ
慢靈魂=ㄇㄌㄏ
唱歌乎恁聽=ㄔㄍㄏㄖㄊ
無情的電影票(純伴奏)=ㄨㄑㄉㄉㄧㄆ(ㄔㄅㄗ)
是阮=ㄕㄖ
多情玫瑰=ㄉㄑㄇㄍ
女人的選擇=ㄋㄖㄉㄒㄗ
偷偷的=ㄊㄊㄉ
你就是吃定我=ㄋㄐㄕㄔㄉㄨ
魏嘉榆,方順吉=ㄨㄐㄩ,ㄈㄕㄐ
大人的世界(純伴奏)=ㄉㄖㄉㄕㄐ(ㄔㄅㄗ)
一百種孤獨的理由=ㄧㄅㄓㄍㄉㄉㄌㄧ
永遠=ㄩㄩ
乎妳水噹噹=ㄏㄋㄕㄉㄉ
畫(純伴奏)=ㄏ(ㄔㄅㄗ)
感覺犯=ㄍㄐㄈ
野薔薇=ㄧㄑㄨ
眼淚成詩=ㄧㄌㄔㄕ
藍又時=ㄌㄧㄕ
紅色高跟鞋=ㄏㄙㄍㄍㄒ
金門王李炳輝=ㄐㄇㄨㄌㄅㄏ
王彩樺=ㄨㄘㄏ
捨不得你=ㄕㄅㄉㄋ
因為妳的愛=ㄧㄨㄋㄉㄞ
愚人碼頭=ㄩㄖㄇㄊ
等呀等=ㄉㄧㄉ
心跳的證明=ㄒㄊㄉㄓㄇ
癡情台西港=ㄔㄑㄊㄒㄍ
陳亞蘭=ㄔㄧㄌ
孤芳自賞(純伴奏)=ㄍㄈㄗㄕ(ㄔㄅㄗ)
落花成泥(純伴奏)=ㄌㄏㄔㄋ(ㄔㄅㄗ)
人生擂台(純伴奏)=ㄖㄕㄌㄊ(ㄔㄅㄗ)
兩個人的幸運=ㄌㄍㄖㄉㄒㄩ
三月=ㄙㄩ
石錦航=ㄕㄐㄏ
許志安,許慧欣=ㄒㄓㄢ,ㄒㄏㄒ
林良歡=ㄌㄌㄏ
無剩=ㄨㄕ
美黛=ㄇㄉ
感受=ㄍㄕ
忍=ㄖ
白蛇傳說=ㄅㄕㄓㄕ
約定=ㄩㄉ
寄相思=ㄐㄒㄙ
相思比夢長=ㄒㄙㄅㄇㄔ
月亮可以代表我的心=ㄩㄌㄎㄧㄉㄅㄨㄉㄒ
飛蛾撲火=ㄈㄜㄆㄏ
立春(純伴奏)=ㄌㄔ(ㄔㄅㄗ)
敗將=ㄅㄐ
心痛袂清醒=ㄒㄊㄇㄑㄒ
女孩=ㄋㄏ
無奈悲歌=ㄨㄋㄅㄍ
開不了口(純伴奏)=ㄎㄅㄌㄎ(ㄔㄅㄗ)
敞開我心=ㄔㄎㄨㄒ
離別的月台票=ㄌㄅㄉㄩㄊㄆ
情路放我過=ㄑㄌㄈㄨㄍ
不愛最大=ㄅㄞㄗㄉ
黑玫瑰(純伴奏)=ㄏㄇㄍ(ㄔㄅㄗ)
彌補=ㄇㄅ
剛好遇見你=ㄍㄏㄩㄐㄋ
光陰的故事=ㄍㄧㄉㄍㄕ
多想在平庸的生活擁抱你(純伴奏)=ㄉㄒㄗㄆㄩㄉㄕㄏㄩㄅㄋ(ㄔㄅㄗ)
偷偷的(純伴奏)=ㄊㄊㄉ(ㄔㄅㄗ)
你聽聽就好=ㄋㄊㄊㄐㄏ
莊雯琪,林耿立,莊采宸=ㄓㄨㄑ,ㄌㄍㄌ,ㄓㄘㄔ
朱俐靜陳勢安=ㄓㄌㄐㄔㄕㄢ
范瑋琪,梁靜茹=ㄈㄨㄑ,ㄌㄐㄖ
你不知道的事(純伴奏)=ㄋㄅㄓㄉㄉㄕ(ㄔㄅㄗ)
月亮代表我的心=ㄩㄌㄉㄅㄨㄉㄒ
以分手為前提=ㄧㄈㄕㄨㄑㄊ
側臉(純伴奏)=ㄘㄌ(ㄔㄅㄗ)
太想愛你=ㄊㄒㄞㄋ
請你攏收回=ㄑㄋㄌㄕㄏ
李玟,丁子峻=ㄌㄨ,ㄉㄗㄐ
女力報到防疫大使=ㄋㄌㄅㄉㄈㄧㄉㄕ
四季謠(純伴奏)=ㄙㄐㄧ(ㄔㄅㄗ)
心太軟=ㄒㄊㄖ
全世界失眠(純伴奏)=ㄑㄕㄐㄕㄇ(ㄔㄅㄗ)
我的歌為你唱=ㄨㄉㄍㄨㄋㄔ
如果我變成回憶=ㄖㄍㄨㄅㄔㄏㄧ
微微=ㄨㄨ
戴梅君林俊吉=ㄉㄇㄐㄌㄐㄐ
不要騙我=ㄅㄧㄆㄨ
甄秀珍=ㄓㄒㄓ
夜空=ㄧㄎ
愛你愛到心痛=ㄞㄋㄞㄉㄒㄊ
無悔=ㄨㄏ
問籤詩=ㄨㄑㄕ
只能勇敢=ㄓㄋㄩㄍ
陳嘉樺,呂建中=ㄔㄐㄏ,ㄌㄐㄓ
蔡淳佳=ㄘㄔㄐ
望春風=ㄨㄔㄈ
平行線=ㄆㄒㄒ
謝和弦=ㄒㄏㄒ
紫藤花=ㄗㄊㄏ
不痛=ㄅㄊ
李夢尹=ㄌㄇㄧ
妄想=ㄨㄒ
鬼迷心竅=ㄍㄇㄒㄑ
祝你快樂=ㄓㄋㄎㄌ
癡情的淚=ㄔㄑㄉㄌ
你的眼神=ㄋㄉㄧㄕ
愛的耳勾=ㄞㄉㄦㄍ
那麼愛你為什麼=ㄋㄇㄞㄋㄨㄕㄇ
一人水一項=ㄧㄖㄕㄧㄒ
人海中遇見你(純伴奏)=ㄖㄏㄓㄩㄐㄋ(ㄔㄅㄗ)
八三夭,=ㄅㄙㄧ,
天公疼憨人=ㄊㄍㄊㄏㄖ
無望=ㄨㄨ
雨和眼淚=ㄩㄏㄧㄌ
杯中影(純伴奏)=ㄅㄓㄧ(ㄔㄅㄗ)
施孝榮=ㄕㄒㄖ
傷不起=ㄕㄅㄑ
世本常態=ㄕㄅㄔㄊ
我太傻=ㄨㄊㄕ
忙與盲=ㄇㄩㄇ
真情難收=ㄓㄑㄋㄕ
你老了=ㄋㄌㄌ
人工智能=ㄖㄍㄓㄋ
憂愁的牡丹(純伴奏)=ㄧㄔㄉㄇㄉ(ㄔㄅㄗ)
吃人一口還人一斗=ㄔㄖㄧㄎㄏㄖㄧㄉ
多情蝴蝶=ㄉㄑㄏㄉ
內山姑娘嫁了後=ㄋㄕㄍㄋㄐㄌㄏ
忽然東風=ㄏㄖㄉㄈ
迷路=ㄇㄌ
孝女的願望=ㄒㄋㄉㄩㄨ
四季=ㄙㄐ
非賣品=ㄈㄇㄆ
男兒情淚(純伴奏)=ㄋㄦㄑㄌ(ㄔㄅㄗ)
張惠妹,蕭敬騰=ㄓㄏㄇ,ㄒㄐㄊ
月亮公園=ㄩㄌㄍㄩ
黑色毛衣=ㄏㄙㄇㄧ
李建復=ㄌㄐㄈ
快瘋了=ㄎㄈㄌ
溫暖的雙手=ㄨㄋㄉㄕㄕ
對阮愛一半=ㄉㄖㄞㄧㄅ
又圓了的月亮=ㄧㄩㄌㄉㄩㄌ
大風=ㄉㄈ
精忠报国=ㄐㄓㄅㄍ
慢冷(純伴奏)=ㄇㄌ(ㄔㄅㄗ)
級娛樂=ㄐㄩㄌ
天才與白痴=ㄊㄘㄩㄅㄔ
活著是最好的死亡=ㄏㄓㄕㄗㄏㄉㄙㄨ
李明洋=ㄌㄇㄧ
老婆=ㄌㄆ
傷心第四台=ㄕㄒㄉㄙㄊ
後來遇見他=ㄏㄌㄩㄐㄊ
肆無忌憚=ㄙㄨㄐㄉ
起了毛球=ㄑㄌㄇㄑ
回想曲=ㄏㄒㄑ
敲敲(純伴奏)=ㄑㄑ(ㄔㄅㄗ)
兔子牙=ㄊㄗㄧ
獻上感恩=ㄒㄕㄍㄣ
陳芳語,劉德熙,陳語嫣,李紫婷,吳映香=ㄔㄈㄩ,ㄌㄉㄒ,ㄔㄩㄧ,ㄌㄗㄊ,ㄨㄧㄒ
我錯=ㄨㄘ
光年之外=ㄍㄋㄓㄨ
我夏流=ㄨㄒㄌ
召喚獸=ㄓㄏㄕ
牽心萬苦=ㄑㄒㄨㄎ
從這代到那代=ㄘㄓㄉㄉㄋㄉ
會呼吸的痛=ㄏㄏㄒㄉㄊ
玫瑰人生=ㄇㄍㄖㄕ
甩啦甩啦=ㄕㄌㄕㄌ
盧廣仲=ㄌㄍㄓ
不具名的悲傷=ㄅㄐㄇㄉㄅㄕ
一顆紅豆=ㄧㄎㄏㄉ
瘋子=ㄈㄗ
心事=ㄒㄕ
每一個玩音樂的人=ㄇㄧㄍㄨㄧㄌㄉㄖ
終於等到你(純伴奏)=ㄓㄩㄉㄉㄋ(ㄔㄅㄗ)
只想抱著你=ㄓㄒㄅㄓㄋ
外面的世界(純伴奏)=ㄨㄇㄉㄕㄐ(ㄔㄅㄗ)
我不配=ㄨㄅㄆ
手心的太陽=ㄕㄒㄉㄊㄧ
事到如今=ㄕㄉㄖㄐ
特別的愛給特別的你=ㄊㄅㄉㄞㄍㄊㄅㄉㄋ
劉嘉亮=ㄌㄐㄌ
阿郎行船曲=ㄚㄌㄒㄔㄑ
林佑威=ㄌㄧㄨ
周蕙楊永聰=ㄓㄏㄧㄩㄘ
王思佳=ㄨㄙㄐ
庭竹=ㄊㄓ
現象學=ㄒㄒㄒ
愛你一生=ㄞㄋㄧㄕ
我想我挺好的=ㄨㄒㄨㄊㄏㄉ
吳克群,鍾欣桐=ㄨㄎㄑ,ㄓㄒㄊ
天=ㄊ
甘甜的愛=ㄍㄊㄉㄞ
你是此生最美的風景=ㄋㄕㄘㄕㄗㄇㄉㄈㄐ
天衣無縫=ㄊㄧㄨㄈ
孤家寡人=ㄍㄐㄍㄖ
再生=ㄗㄕ
別讓我最後才知道=ㄅㄖㄨㄗㄏㄘㄓㄉ
水從天上來=ㄕㄘㄊㄕㄌ
瀘沽尋夢=ㄌㄍㄒㄇ
貝瓦兒歌=ㄅㄨㄦㄍ
中意他=ㄓㄧㄊ
思鄉情歌=ㄙㄒㄑㄍ
濛濛春雨(純伴奏)=ㄇㄇㄔㄩ(ㄔㄅㄗ)
逆光=ㄋㄍ
岩石裡的花=ㄧㄕㄌㄉㄏ
裂縫中的陽光=ㄌㄈㄓㄉㄧㄍ
步步=ㄅㄅ
流水年華=ㄌㄕㄋㄏ
候鳥(純伴奏)=ㄏㄋ(ㄔㄅㄗ)
夏天的浪花=ㄒㄊㄉㄌㄏ
彼得潘=ㄅㄉㄆ
愛到坎站=ㄞㄉㄎㄓ
內山姑娘要出嫁=ㄋㄕㄍㄋㄧㄔㄐ
海波浪=ㄏㄆㄌ
好朋友的祝福=ㄏㄆㄧㄉㄓㄈ
給你!呆呆!=ㄍㄋ!ㄞㄞ!
你要的不是我=ㄋㄧㄉㄅㄕㄨ
借問愛情=ㄐㄨㄞㄑ
愛江山更愛美人=ㄞㄐㄕㄍㄞㄇㄖ
明明不是=ㄇㄇㄅㄕ
親愛的路人=ㄑㄞㄉㄌㄖ
隨時都在=ㄙㄕㄉㄗ
愛到站了=ㄞㄉㄓㄌ
蝴蝶秀=ㄏㄉㄒ
普通朋友=ㄆㄊㄆㄧ
其實我也不知道=ㄑㄕㄨㄧㄅㄓㄉ
少年=ㄕㄋ
愛在西元前=ㄞㄗㄒㄩㄑ
沒有理由=ㄇㄧㄌㄧ
海洋之心=ㄏㄧㄓㄒ
愛我別走(純伴奏)=ㄞㄨㄅㄗ(ㄔㄅㄗ)
離開=ㄌㄎ
最近好嗎=ㄗㄐㄏㄇ
寂寞的男人=ㄐㄇㄉㄋㄖ
活著多好=ㄏㄓㄉㄏ
征服(純伴奏)=ㄓㄈ(ㄔㄅㄗ)
困獸之鬥(純伴奏)=ㄎㄕㄓㄉ(ㄔㄅㄗ)
十七歲女生的溫柔=ㄕㄑㄙㄋㄕㄉㄨㄖ
青青校樹=ㄑㄑㄒㄕ
心不名狀=ㄒㄅㄇㄓ
愛妳無目地=ㄞㄋㄨㄇㄉ
二缺一=ㄦㄑㄧ
騙吃騙吃=ㄆㄔㄆㄔ
太陽=ㄊㄧ
梁朝偉=ㄌㄔㄨ
求籤=ㄑㄑ
劉思涵=ㄌㄙㄏ
小手拉大手(純伴奏)=ㄒㄕㄌㄉㄕ(ㄔㄅㄗ)
心痛的感覺=ㄒㄊㄉㄍㄐ
男人啊=ㄋㄖㄚ
雨一直下=ㄩㄧㄓㄒ
糊塗=ㄏㄊ
談詩玲,楊哲=ㄊㄕㄌ,ㄧㄓ
騙吃騙吃(純伴奏)=ㄆㄔㄆㄔ(ㄔㄅㄗ)
她說=ㄊㄕ
因你而在=ㄧㄋㄦㄗ
七月七日晴=ㄑㄩㄑㄖㄑ
春花秋月=ㄔㄏㄑㄩ
浪子的心情=ㄌㄗㄉㄒㄑ
水潑落地難收回=ㄕㄆㄌㄉㄋㄕㄏ
江淑娜=ㄐㄕㄋ
劉藍溪=ㄌㄌㄒ
李友廷,吳霏,楊碧琪=ㄌㄧㄊ,ㄨㄈ,ㄧㄅㄑ
愛我好嗎=ㄞㄨㄏㄇ
最快樂那一年=ㄗㄎㄌㄋㄧㄋ
簡簡單單=ㄐㄐㄉㄉ
愛的真諦=ㄞㄉㄓㄉ
救贖的恩典=ㄐㄕㄉㄣㄉ
’=’
曾慶瑜=ㄘㄑㄩ
底線=ㄉㄒ
真情夢=ㄓㄑㄇ
白吉勝=ㄅㄐㄕ
多情城市(純伴奏)=ㄉㄑㄔㄕ(ㄔㄅㄗ)
可恨可愛的人=ㄎㄏㄎㄞㄉㄖ
常艾非=ㄔㄞㄈ
棒棒堂=ㄅㄅㄊ
笑紅塵(純伴奏)=ㄒㄏㄔ(ㄔㄅㄗ)
痴情憨夢=ㄔㄑㄏㄇ
說不出的味道(純伴奏)=ㄕㄅㄔㄉㄨㄉ(ㄔㄅㄗ)
自從有了你=ㄗㄘㄧㄌㄋ
你那麼愛她=ㄋㄋㄇㄞㄊ
讓愛重生=ㄖㄞㄔㄕ
等你是一個人=ㄉㄋㄕㄧㄍㄖ
異鄉悲戀夢(純伴奏)=ㄧㄒㄅㄌㄇ(ㄔㄅㄗ)
我的果汁分你一半=ㄨㄉㄍㄓㄈㄋㄧㄅ
你怎麼捨得我難過(純伴奏)=ㄋㄗㄇㄕㄉㄨㄋㄍ(ㄔㄅㄗ)
不如這樣吧=ㄅㄖㄓㄧㄅ
王嘉爾=ㄨㄐㄦ
終於勇敢了=ㄓㄩㄩㄍㄌ
煙雨濛濛=ㄧㄩㄇㄇ
雪落下的聲音(純伴奏)=ㄒㄌㄒㄉㄕㄧ(ㄔㄅㄗ)
夏雪=ㄒㄒ
月娘金金看=ㄩㄋㄐㄐㄎ
陳欣斈=ㄔㄒ斈
打分數=ㄉㄈㄕ
千言萬語=ㄑㄧㄨㄩ
你是唯一=ㄋㄕㄨㄧ
長大以後(純伴奏)=ㄓㄉㄧㄏ(ㄔㄅㄗ)
…=…
寓言=ㄩㄧ
忘記擁抱=ㄨㄐㄩㄅ
周杰,林心如=ㄓㄐ,ㄌㄒㄖ
月亮惹的禍(純伴奏)=ㄩㄌㄖㄉㄏ(ㄔㄅㄗ)
祝瑞蓮=ㄓㄖㄌ
我不想忘記你=ㄨㄅㄒㄨㄐㄋ
告訴我=ㄍㄙㄨ
人=ㄖ
曹格,許瑋倫=ㄘㄍ,ㄒㄨㄌ
我總是一個人在練習一個人=ㄨㄗㄕㄧㄍㄖㄗㄌㄒㄧㄍㄖ
秋詞=ㄑㄘ
不要問=ㄅㄧㄨ
王傳一=ㄨㄔㄧ
台北的夜空下=ㄊㄅㄉㄧㄎㄒ
忘不了=ㄨㄅㄌ
數星星的人=ㄕㄒㄒㄉㄖ
無心石(純伴奏)=ㄨㄒㄕ(ㄔㄅㄗ)
受罪=ㄕㄗ
ㄘㄨㄚˋ冰進行曲=ㄘㄨㄚˋㄅㄐㄒㄑ
風中的承諾(純伴奏)=ㄈㄓㄉㄔㄋ(ㄔㄅㄗ)
我不是你該愛的那個人=ㄨㄅㄕㄋㄍㄞㄉㄋㄍㄖ
心無塊寄=ㄒㄨㄎㄐ
你在煩惱什麼=ㄋㄗㄈㄋㄕㄇ
邱鋒澤,偉晉=ㄑㄈㄗ,ㄨㄐ
壯志驕陽=ㄓㄓㄐㄧ
愛你，不是我的=ㄞㄋ，ㄅㄕㄨㄉ
燕窩=ㄧㄨ
習慣愛你=ㄒㄍㄞㄋ
買你=ㄇㄋ
如何忘記你=ㄖㄏㄨㄐㄋ
心雨=ㄒㄩ
第一個想到你=ㄉㄧㄍㄒㄉㄋ
戀戀不捨=ㄌㄌㄅㄕ
壓在地上打=ㄧㄗㄉㄕㄉ
快樂的舞池=ㄎㄌㄉㄨㄔ
我們愛戴的王=ㄨㄇㄞㄉㄉㄨ
失聲=ㄕㄕ
喜酒甜茶好日子=ㄒㄐㄊㄔㄏㄖㄗ
給我清潔的心=ㄍㄨㄑㄐㄉㄒ
沙文=ㄕㄨ
進退攏為難(純伴奏)=ㄐㄊㄌㄨㄋ(ㄔㄅㄗ)
現在流行什麼=ㄒㄗㄌㄒㄕㄇ
人生的歌=ㄖㄕㄉㄍ
我願你知道=ㄨㄩㄋㄓㄉ
就在今夜=ㄐㄗㄐㄧ
我要你好好的=ㄨㄧㄋㄏㄏㄉ
余天李亞萍=ㄩㄊㄌㄧㄆ
愛情甘講已經過=ㄞㄑㄍㄐㄧㄐㄍ
簡單愛(純伴奏)=ㄐㄉㄞ(ㄔㄅㄗ)
張三李四=ㄓㄙㄌㄙ
呀邊個邊個=ㄧㄅㄍㄅㄍ
種生活=ㄓㄕㄏ
梅蘭梅蘭我愛你=ㄇㄌㄇㄌㄨㄞㄋ
情歌(純伴奏)=ㄑㄍ(ㄔㄅㄗ)
好久不見(純伴奏)=ㄏㄐㄅㄐ(ㄔㄅㄗ)
林子娟=ㄌㄗㄐ
私奔到月球=ㄙㄅㄉㄩㄑ
單=ㄉ
讓我逃離平庸的生活=ㄖㄨㄊㄌㄆㄩㄉㄕㄏ
愛我還是他=ㄞㄨㄏㄕㄊ
多想留在你身邊(純伴奏)=ㄉㄒㄌㄗㄋㄕㄅ(ㄔㄅㄗ)
無路可退=ㄨㄌㄎㄊ
張棟樑=ㄓㄉㄌ
留給你的窗=ㄌㄍㄋㄉㄔ
愛到抹凍愛=ㄞㄉㄇㄉㄞ
石康鈞=ㄕㄎㄐ
最熟悉的陌生人=ㄗㄕㄒㄉㄇㄕㄖ
戴愛玲,國蛋=ㄉㄞㄌ,ㄍㄉ
再會夜都市=ㄗㄏㄧㄉㄕ
鍾嘉欣=ㄓㄐㄒ
新貴妃醉酒=ㄒㄍㄈㄗㄐ
現在我很幸福=ㄒㄗㄨㄏㄒㄈ
為你寫詩=ㄨㄋㄒㄕ
星夜的離別=ㄒㄧㄉㄌㄅ
來自天堂的魔鬼=ㄌㄗㄊㄊㄉㄇㄍ
若是有一天(純伴奏)=ㄖㄕㄧㄧㄊ(ㄔㄅㄗ)
第三類接觸=ㄉㄙㄌㄐㄔ
今年夏天=ㄐㄋㄒㄊ
吳卓源,陳芳語=ㄨㄓㄩ,ㄔㄈㄩ
飛行部落(純伴奏)=ㄈㄒㄅㄌ(ㄔㄅㄗ)
懂我再愛我=ㄉㄨㄗㄞㄨ
越唱越大聲=ㄩㄔㄩㄉㄕ
情人的眼淚(純伴奏)=ㄑㄖㄉㄧㄌ(ㄔㄅㄗ)
信愛成癮=ㄒㄞㄔㄧ
做我自己=ㄗㄨㄗㄐ
用情=ㄩㄑ
大夢想家(純伴奏)=ㄉㄇㄒㄐ(ㄔㄅㄗ)
袁詠琳,周杰倫=ㄩㄩㄌ,ㄓㄐㄌ
星空=ㄒㄎ
加加油=ㄐㄐㄧ
路彎彎=ㄌㄨㄨ
到底怎麼了(純伴奏)=ㄉㄉㄗㄇㄌ(ㄔㄅㄗ)
人來人往=ㄖㄌㄖㄨ
明知故問=ㄇㄓㄍㄨ
魚仔=ㄩㄗ
楊欣樺=ㄧㄒㄏ
情靠岸=ㄑㄎㄢ
以後以後=ㄧㄏㄧㄏ
蔡詩蕓=ㄘㄕㄩ
問花=ㄨㄏ
奇遇記=ㄑㄩㄐ
你愛的不是我=ㄋㄞㄉㄅㄕㄨ
流浪找頭路(純伴奏)=ㄌㄌㄓㄊㄌ(ㄔㄅㄗ)
優雅道別=ㄧㄧㄉㄅ
春風有情=ㄔㄈㄧㄑ
天使的指紋=ㄊㄕㄉㄓㄨ
其實沒聊什麼=ㄑㄕㄇㄌㄕㄇ
不用去猜(純伴奏)=ㄅㄩㄑㄘ(ㄔㄅㄗ)
是祢的愛\=ㄕㄋㄉㄞ\
吳國敬,莫文蔚=ㄨㄍㄐ,ㄇㄨㄨ
親愛的小孩=ㄑㄞㄉㄒㄏ
癡心等無愛=ㄔㄒㄉㄨㄞ
溫昇豪=ㄨㄕㄏ
陳柏宇=ㄔㄅㄩ
最接近永恆的事情=ㄗㄐㄐㄩㄏㄉㄕㄑ
分手吧=ㄈㄕㄅ
偶爾=ㄡㄦ
雨天(純伴奏)=ㄩㄊ(ㄔㄅㄗ)
雨眠=ㄩㄇ
命=ㄇ
握住幸福=ㄨㄓㄒㄈ
嗆聲=ㄑㄕ
張葉蕾=ㄓㄧㄌ
大風吹(純伴奏)=ㄉㄈㄔ(ㄔㄅㄗ)
薛凱琪陳意涵楊子姗=ㄒㄎㄑㄔㄧㄏㄧㄗㄒ
有夢可待=ㄧㄇㄎㄉ
幸福無關=ㄒㄈㄨㄍ
林俊吉許慧盈=ㄌㄐㄐㄒㄏㄧ
阿桑=ㄚㄙ
我要看見=ㄨㄧㄎㄐ
就站在這裡=ㄐㄓㄗㄓㄌ
一代佳人=ㄧㄉㄐㄖ
碼頭姑娘=ㄇㄊㄍㄋ
瘦瘦的=ㄕㄕㄉ
返去故鄉=ㄈㄑㄍㄒ
不用告訴我=ㄅㄩㄍㄙㄨ
眼淚笑了=ㄧㄌㄒㄌ
長大(純伴奏)=ㄓㄉ(ㄔㄅㄗ)
披著羊皮的狼=ㄆㄓㄧㄆㄉㄌ
時間的味道=ㄕㄐㄉㄨㄉ
紋身=ㄨㄕ
最笨的人是我=ㄗㄅㄉㄖㄕㄨ
你的酒館對我打了烊=ㄋㄉㄐㄍㄉㄨㄉㄌㄧ
何年何月再相逢=ㄏㄋㄏㄩㄗㄒㄈ
熱量=ㄖㄌ
花千樹=ㄏㄑㄕ
半獸人=ㄅㄕㄖ
探獄思君怨(純伴奏)=ㄊㄩㄙㄐㄩ(ㄔㄅㄗ)
吻得太逼真=ㄨㄉㄊㄅㄓ
血肉果汁機=ㄒㄖㄍㄓㄐ
拍檔=ㄆㄉ
終於明白=ㄓㄩㄇㄅ
歌聲戀情(純伴奏)=ㄍㄕㄌㄑ(ㄔㄅㄗ)
算計的腦袋=ㄙㄐㄉㄋㄉ
信=ㄒ
你給我聽好=ㄋㄍㄨㄊㄏ
一時風一時雨=ㄧㄕㄈㄧㄕㄩ
本草綱目=ㄅㄘㄍㄇ
女人的心願(純伴奏)=ㄋㄖㄉㄒㄩ(ㄔㄅㄗ)
願祢降臨=ㄩㄋㄐㄌ
你敢不敢=ㄋㄍㄅㄍ
回憶的閣樓=ㄏㄧㄉㄍㄌ
別丟下我不管(純伴奏)=ㄅㄉㄒㄨㄅㄍ(ㄔㄅㄗ)
我要陪著你老去=ㄨㄧㄆㄓㄋㄌㄑ
馬賽克=ㄇㄙㄎ
八三夭,孫盛希=ㄅㄙㄧ,ㄙㄕㄒ
周慧敏=ㄓㄏㄇ
相思苦問蒼天=ㄒㄙㄎㄨㄘㄊ
向蕙玲,莊振凱=ㄒㄏㄌ,ㄓㄓㄎ
第三人稱=ㄉㄙㄖㄔ
最重要的決定=ㄗㄓㄧㄉㄐㄉ
最後的請求=ㄗㄏㄉㄑㄑ
生長=ㄕㄓ
有多少愛可以重來=ㄧㄉㄕㄞㄎㄧㄔㄌ
不想這是場戲=ㄅㄒㄓㄕㄔㄒ
傷心=ㄕㄒ
五月天,羅志祥=ㄨㄩㄊ,ㄌㄓㄒ
給我一個理由忘記=ㄍㄨㄧㄍㄌㄧㄨㄐ
方圓幾里=ㄈㄩㄐㄌ
分分鐘需要你=ㄈㄈㄓㄒㄧㄋ
乾杯=ㄍㄅ
施易男=ㄕㄧㄋ
楊奇煜=ㄧㄑㄩ
今天不回家=ㄐㄊㄅㄏㄐ
吳建豪=ㄨㄐㄏ
惦惦離開=ㄉㄉㄌㄎ
向蕙玲=ㄒㄏㄌ
嘉賓=ㄐㄅ
理想情人=ㄌㄒㄑㄖ
心肝寶貝=ㄒㄍㄅㄅ
衝動=ㄔㄉ
風雨情=ㄈㄩㄑ
直到我遇見了你=ㄓㄉㄨㄩㄐㄌㄋ
酒よ=ㄐよ
珊瑚海=ㄕㄏㄏ
故鄉的雲=ㄍㄒㄉㄩ
那對夫妻林京燁=ㄋㄉㄈㄑㄌㄐㄧ
用心=ㄩㄒ
林明日香=ㄌㄇㄖㄒ
張立昂=ㄓㄌㄤ
蕭全=ㄒㄑ
黃昏孤燈(純伴奏)=ㄏㄏㄍㄉ(ㄔㄅㄗ)
祝福(純伴奏)=ㄓㄈ(ㄔㄅㄗ)
沒有你的每一天=ㄇㄧㄋㄉㄇㄧㄊ
不為誰而作的歌(純伴奏)=ㄅㄨㄕㄦㄗㄉㄍ(ㄔㄅㄗ)
記得愛=ㄐㄉㄞ
我想你的快樂是因為我=ㄨㄒㄋㄉㄎㄌㄕㄧㄨㄨ
路邊的野花不要採=ㄌㄅㄉㄧㄏㄅㄧㄘ
缺口(純伴奏)=ㄑㄎ(ㄔㄅㄗ)
如果還有明天=ㄖㄍㄏㄧㄇㄊ
蕭蕭=ㄒㄒ
無事生非(純伴奏)=ㄨㄕㄕㄈ(ㄔㄅㄗ)
當我遇上你=ㄉㄨㄩㄕㄋ
無你惦身邊=ㄨㄋㄉㄕㄅ
心理遊戲=ㄒㄌㄧㄒ
製造浪漫=ㄓㄗㄌㄇ
結婚鑽戒=ㄐㄏㄗㄐ
梁一貞=ㄌㄧㄓ
盜將行=ㄉㄐㄒ
詹曼鈴=ㄓㄇㄌ
外婆=ㄨㄆ
愛那麼重=ㄞㄋㄇㄔ
病變(純伴奏)=ㄅㄅ(ㄔㄅㄗ)
光源=ㄍㄩ
失戀的解藥=ㄕㄌㄉㄐㄧ
無菇朋友=ㄨㄍㄆㄧ
愛情密碼=ㄞㄑㄇㄇ
第二性=ㄉㄦㄒ
愛夏=ㄞㄒ
小藍背心=ㄒㄌㄅㄒ
媽媽的皺紋=ㄇㄇㄉㄓㄨ
可愛女人=ㄎㄞㄋㄖ
體面=ㄊㄇ
夢中再相會=ㄇㄓㄗㄒㄏ
劉濤=ㄌㄊ
一翦梅=ㄧㄐㄇ
離開你走近你(純伴奏)=ㄌㄎㄋㄗㄐㄋ(ㄔㄅㄗ)
吾在場證明=ㄨㄗㄔㄓㄇ
黃金比例=ㄏㄐㄅㄌ
愫=ㄙ
春天哪會這呢寒=ㄔㄊㄋㄏㄓㄋㄏ
夢醒又一回=ㄇㄒㄧㄧㄏ
牽線=ㄑㄒ
張澤熙=ㄓㄗㄒ
憨情人=ㄏㄑㄖ
戰勝巨人的恩膏=ㄓㄕㄐㄖㄉㄣㄍ
郭美美=ㄍㄇㄇ
我願意平凡的陪在你身旁=ㄨㄩㄧㄆㄈㄉㄆㄗㄋㄕㄆ
表示=ㄅㄕ
很久很久以後=ㄏㄐㄏㄐㄧㄏ
戀情海=ㄌㄑㄏ
破碎心嘛無人管=ㄆㄙㄒㄇㄨㄖㄍ
十五暝的月台=ㄕㄨㄇㄉㄩㄊ
停了的鐘=ㄊㄌㄉㄓ
鞋子特大號=ㄒㄗㄊㄉㄏ
我是女生=ㄨㄕㄋㄕ
愛因斯坦=ㄞㄧㄙㄊ
被遺忘的時光=ㄅㄧㄨㄉㄕㄍ
動物世界=ㄉㄨㄕㄐ
過渡期=ㄍㄉㄑ
怪獸大學=ㄍㄕㄉㄒ
起來=ㄑㄌ
擁抱=ㄩㄅ
欠情歌=ㄑㄑㄍ
心聲淚痕=ㄒㄕㄌㄏ
親眼見你=ㄑㄧㄐㄋ
暗號=ㄢㄏ
無字碑=ㄨㄗㄅ
愛久見人心=ㄞㄐㄐㄖㄒ
謊言=ㄏㄧ
愛不顧身=ㄞㄅㄍㄕ
充氧期=ㄔㄧㄑ
小蟲=ㄒㄔ
堆積=ㄉㄐ
一點點力量=ㄧㄉㄉㄌㄌ
雷深如=ㄌㄕㄖ
林逸欣=ㄌㄧㄒ
不會痛的不叫愛情=ㄅㄏㄊㄉㄅㄐㄞㄑ
即時生效=ㄐㄕㄕㄒ
別哭了=ㄅㄎㄌ
陳怡婷=ㄔㄧㄊ
曾之喬阿沁=ㄘㄓㄑㄚㄑ
當我想起你=ㄉㄨㄒㄑㄋ
在旅行的路上=ㄗㄌㄒㄉㄌㄕ
我不是饒舌歌手(純伴奏)=ㄨㄅㄕㄖㄕㄍㄕ(ㄔㄅㄗ)
平安夜=ㄆㄢㄧ
離心力=ㄌㄒㄌ
人生擂台=ㄖㄕㄌㄊ
離人=ㄌㄖ
寵物=ㄔㄨ
悲傷止步=ㄅㄕㄓㄅ
愛需要勇氣=ㄞㄒㄧㄩㄑ
注目看耶穌=ㄓㄇㄎㄧㄙ
消滅=ㄒㄇ
壯志在我胸=ㄓㄓㄗㄨㄒ
楊紫=ㄧㄗ
好久不見=ㄏㄐㄅㄐ
楊冪=ㄧㄇ
星星點燈=ㄒㄒㄉㄉ
魚=ㄩ
十二月的情批=ㄕㄦㄩㄉㄑㄆ
筷子兄弟=ㄎㄗㄒㄉ
該死的溫柔=ㄍㄙㄉㄨㄖ
長渕剛=ㄔ渕ㄍ
胡=ㄏ
你要的愛(深夜版)=ㄋㄧㄉㄞ(ㄕㄧㄅ)
挑撥=ㄊㄅ
任賢齊農夫=ㄖㄒㄑㄋㄈ
媽媽的話=ㄇㄇㄉㄏ
孫淑媚=ㄙㄕㄇ
榕樹下=ㄖㄕㄒ
趙詠華=ㄓㄩㄏ
與我無關=ㄩㄨㄨㄍ
堂娜=ㄊㄋ
時代少年團=ㄕㄉㄕㄋㄊ
卻上心頭=ㄑㄕㄒㄊ
阿尼基=ㄚㄋㄐ
紙短情長=ㄓㄉㄑㄔ
男兒的心聲=ㄋㄦㄉㄒㄕ
你不要那樣看著我的眼睛(純伴奏)=ㄋㄅㄧㄋㄧㄎㄓㄨㄉㄧㄐ(ㄔㄅㄗ)
陳零九=ㄔㄌㄐ
一點點光(純伴奏)=ㄧㄉㄉㄍ(ㄔㄅㄗ)
真情卸落海=ㄓㄑㄒㄌㄏ
孟庭葦=ㄇㄊㄨ
明天再擱來=ㄇㄊㄗㄍㄌ
春天的露水=ㄔㄊㄉㄌㄕ
嫁給我吧=ㄐㄍㄨㄅ
我的救贖者活著=ㄨㄉㄐㄕㄓㄏㄓ
終結孤單=ㄓㄐㄍㄉ
把回憶拼好給你=ㄅㄏㄧㄆㄏㄍㄋ
黃瑋傑=ㄏㄨㄐ
都是你害的=ㄉㄕㄋㄏㄉ
今夜想你=ㄐㄧㄒㄋ
一口一口=ㄧㄎㄧㄎ
你甘會體會=ㄋㄍㄏㄊㄏ
給我感覺=ㄍㄨㄍㄐ
恨愛不成鋼=ㄏㄞㄅㄔㄍ
深情海=ㄕㄑㄏ
不是你的錯=ㄅㄕㄋㄉㄘ
來自第五大道的明信片=ㄌㄗㄉㄨㄉㄉㄉㄇㄒㄆ
為愛認份=ㄨㄞㄖㄈ
可不可以(純伴奏)=ㄎㄅㄎㄧ(ㄔㄅㄗ)
你是我最愚蠢的一次浪漫=ㄋㄕㄨㄗㄩㄔㄉㄧㄘㄌㄇ
床邊故事=ㄔㄅㄍㄕ
前世情人=ㄑㄕㄑㄖ
給未來(純伴奏)=ㄍㄨㄌ(ㄔㄅㄗ)
存在=ㄘㄗ
吳秀珠=ㄨㄒㄓ
我害怕(純伴奏)=ㄨㄏㄆ(ㄔㄅㄗ)
全部都是你(純伴奏)=ㄑㄅㄉㄕㄋ(ㄔㄅㄗ)
戴愛玲,信樂團=ㄉㄞㄌ,ㄒㄩㄊ
愛人啊=ㄞㄖㄚ
于櫻櫻=ㄩㄧㄧ
紙玫瑰=ㄓㄇㄍ
春分(純伴奏)=ㄔㄈ(ㄔㄅㄗ)
有誰共鳴=ㄧㄕㄍㄇ
北島三郎=ㄅㄉㄙㄌ
有你真好=ㄧㄋㄓㄏ
紅顏舊=ㄏㄧㄐ
街角的祝福=ㄐㄐㄉㄓㄈ
溫柔的奇蹟=ㄨㄖㄉㄑㄐ
思念的人=ㄙㄋㄉㄖ
鄭詩樺=ㄓㄕㄏ
同種異類=ㄊㄓㄧㄌ
海草舞(純伴奏)=ㄏㄘㄨ(ㄔㄅㄗ)
暖心=ㄋㄒ
黃瑞琪=ㄏㄖㄑ
陪阮到老=ㄆㄖㄉㄌ
表裏一体=ㄅㄌㄧㄊ
解憂(純伴奏)=ㄐㄧ(ㄔㄅㄗ)
給我一個理由忘記(純伴奏)=ㄍㄨㄧㄍㄌㄧㄨㄐ(ㄔㄅㄗ)
任賢齊=ㄖㄒㄑ
志氣=ㄓㄑ
雙手的溫柔=ㄕㄕㄉㄨㄖ
分手在今夜=ㄈㄕㄗㄐㄧ
流浪者之歌=ㄌㄌㄓㄓㄍ
蘇慧倫=ㄙㄏㄌ
那首歌=ㄋㄕㄍ
逆夢=ㄋㄇ
末班車(純伴奏)=ㄇㄅㄔ(ㄔㄅㄗ)
外婆的澎湖灣=ㄨㄆㄉㄆㄏㄨ
罵醒我=ㄇㄒㄨ
將軍令=ㄐㄐㄌ
你把我灌醉=ㄋㄅㄨㄍㄗ
陳小春=ㄔㄒㄔ
痴心絕對(純伴奏)=ㄔㄒㄐㄉ(ㄔㄅㄗ)
今夜妳會不會來(純伴奏)=ㄐㄧㄋㄏㄅㄏㄌ(ㄔㄅㄗ)
郭采潔=ㄍㄘㄐ
新宿=ㄒㄙ
王昭君=ㄨㄓㄐ
自主型=ㄗㄓㄒ
再見勾勾=ㄗㄐㄍㄍ
過我的生活(純伴奏)=ㄍㄨㄉㄕㄏ(ㄔㄅㄗ)
我們很好(純伴奏)=ㄨㄇㄏㄏ(ㄔㄅㄗ)
恍然大悟=ㄏㄖㄉㄨ
星星的約會=ㄒㄒㄉㄩㄏ
Λ=Λ
當妮走了=ㄉㄋㄗㄌ
我要全心讚美,=ㄨㄧㄑㄒㄗㄇ,
你懂嗎=ㄋㄉㄇ
第一天=ㄉㄧㄊ
日不落=ㄖㄅㄌ
一切如新=ㄧㄑㄖㄒ
負心的人=ㄈㄒㄉㄖ
冷耳光=ㄌㄦㄍ
日日夜夜=ㄖㄖㄧㄧ
王心凌,羅志祥=ㄨㄒㄌ,ㄌㄓㄒ
寂寞保龄球(純伴奏)=ㄐㄇㄅㄌㄑ(ㄔㄅㄗ)
天若有情=ㄊㄖㄧㄑ
我會在你身邊=ㄨㄏㄗㄋㄕㄅ
遊戲=ㄧㄒ
撲火=ㄆㄏ
這一季的浪漫=ㄓㄧㄐㄉㄌㄇ
你在,不在=ㄋㄗ,ㄅㄗ
月光光=ㄩㄍㄍ
再一步=ㄗㄧㄅ
你好嗎=ㄋㄏㄇ
歡喜就好(純伴奏)=ㄏㄒㄐㄏ(ㄔㄅㄗ)
因祂活著=ㄧㄊㄏㄓ
沈文程=ㄕㄨㄔ
別來無恙(純伴奏)=ㄅㄌㄨㄧ(ㄔㄅㄗ)
愛不單行=ㄞㄅㄉㄒ
甲你攬牢牢=ㄐㄋㄌㄌㄌ
微雨=ㄨㄩ
街燈下(純伴奏)=ㄐㄉㄒ(ㄔㄅㄗ)
寂寞來了怎麼辦=ㄐㄇㄌㄌㄗㄇㄅ
香水有毒(純伴奏)=ㄒㄕㄧㄉ(ㄔㄅㄗ)
楊凱琳,余楓=ㄧㄎㄌ,ㄩㄈ
幻影(純伴奏)=ㄏㄧ(ㄔㄅㄗ)
相對無言=ㄒㄉㄨㄧ
漂向北方(純伴奏)=ㄆㄒㄅㄈ(ㄔㄅㄗ)
卡門=ㄎㄇ
莫文蔚,柯有倫=ㄇㄨㄨ,ㄎㄧㄌ
愛情限時批(純伴奏)=ㄞㄑㄒㄕㄆ(ㄔㄅㄗ)
完美=ㄨㄇ
開始懂了=ㄎㄕㄉㄌ
惜花=ㄒㄏ
飛輪海,田馥甄=ㄈㄌㄏ,ㄊㄈㄓ
做你的男人=ㄗㄋㄉㄋㄖ
別在我離開你之前離開我=ㄅㄗㄨㄌㄎㄋㄓㄑㄌㄎㄨ
四面楚歌(純伴奏)=ㄙㄇㄔㄍ(ㄔㄅㄗ)
逆天=ㄋㄊ
張碧晨,鄭雲龍=ㄓㄅㄔ,ㄓㄩㄌ
時針與分針=ㄕㄓㄩㄈㄓ
壓在地上打(純伴奏)=ㄧㄗㄉㄕㄉ(ㄔㄅㄗ)
心的鎖匙=ㄒㄉㄙㄔ
夏天=ㄒㄊ
寂寞星球的玫瑰=ㄐㄇㄒㄑㄉㄇㄍ
雪花的快樂=ㄒㄏㄉㄎㄌ
李袁杰=ㄌㄩㄐ
她很漂亮=ㄊㄏㄆㄌ
大地(粵)=ㄉㄉ(ㄩ)
如歌(純伴奏)=ㄖㄍ(ㄔㄅㄗ)
愛你的誓言=ㄞㄋㄉㄕㄧ
島嶼天光=ㄉㄩㄊㄍ
小烏龜=ㄒㄨㄍ
生存法則(純伴奏)=ㄕㄘㄈㄗ(ㄔㄅㄗ)
唐禹哲=ㄊㄩㄓ
白光=ㄅㄍ
負二代=ㄈㄦㄉ
李白=ㄌㄅ
為愛走千里=ㄨㄞㄗㄑㄌ
山野=ㄕㄧ
鬥陣搖落去=ㄉㄓㄧㄌㄑ
華人敬拜讚美=ㄏㄖㄐㄅㄗㄇ
黑咖啡=ㄏㄎㄈ
天燈啊=ㄊㄉㄚ
一眼瞬間(純伴奏)=ㄧㄧㄕㄐ(ㄔㄅㄗ)
愛可以讓我們在一起=ㄞㄎㄧㄖㄨㄇㄗㄧㄑ
再別康橋=ㄗㄅㄎㄑ
當祢找到我=ㄉㄋㄓㄉㄨ
老歌手=ㄌㄍㄕ
回憶的聖誕節=ㄏㄧㄉㄕㄉㄐ
等著等著就老了(純伴奏)=ㄉㄓㄉㄓㄐㄌㄌ(ㄔㄅㄗ)
離開悲傷=ㄌㄎㄅㄕ
獵=ㄌ
鬼來電=ㄍㄌㄉ
天生慢熟=ㄊㄕㄇㄕ
醫治的活泉=ㄧㄓㄉㄏㄑ
愛過無心=ㄞㄍㄨㄒ
我的新座位=ㄨㄉㄒㄗㄨ
錯愛=ㄘㄞ
我怎麼哭了=ㄨㄗㄇㄎㄌ
陳勢安畢書盡=ㄔㄕㄢㄅㄕㄐ
處暑(純伴奏)=ㄔㄕ(ㄔㄅㄗ)
加減乘除=ㄐㄐㄔㄔ
賴銘偉=ㄌㄇㄨ
癡情乎人吃夠夠=ㄔㄑㄏㄖㄔㄍㄍ
笨小孩=ㄅㄒㄏ
女人的愛=ㄋㄖㄉㄞ
嗯哼=ㄣㄏ
刪拾=ㄕㄕ
棉子=ㄇㄗ
我們都寂寞(純伴奏)=ㄨㄇㄉㄐㄇ(ㄔㄅㄗ)
致愛(純伴奏)=ㄓㄞ(ㄔㄅㄗ)
黑龍=ㄏㄌ
出色=ㄔㄙ
林佳儀=ㄌㄐㄧ
山丘(純伴奏)=ㄕㄑ(ㄔㄅㄗ)
全也活過來=ㄑㄧㄏㄍㄌ
幸福抹等人=ㄒㄈㄇㄉㄖ
有生一天=ㄧㄕㄧㄊ
曼陀羅=ㄇㄊㄌ
紀家盈,茄子蛋=ㄐㄐㄧ,ㄑㄗㄉ
李白(純伴奏)=ㄌㄅ(ㄔㄅㄗ)
閃閃惹人愛=ㄕㄕㄖㄖㄞ
我戀愛了=ㄨㄌㄞㄌ
好愛好散=ㄏㄞㄏㄙ
故事細膩=ㄍㄕㄒㄋ
大眠=ㄉㄇ
進化=ㄐㄏ
詞不達意=ㄘㄅㄉㄧ
我還能愛誰=ㄨㄏㄋㄞㄕ
美麗的情歌=ㄇㄌㄉㄑㄍ
火車叨位去=ㄏㄔㄉㄨㄑ
寒露=ㄏㄌ
我還年輕=ㄨㄏㄋㄑ
思慕的人(純伴奏)=ㄙㄇㄉㄖ(ㄔㄅㄗ)
蔡淳佳金海心=ㄘㄔㄐㄐㄏㄒ
孽海記=ㄋㄏㄐ
董事長樂團=ㄉㄕㄓㄩㄊ
痘痘那邊(純伴奏)=ㄉㄉㄋㄅ(ㄔㄅㄗ)
十萬毫升淚水=ㄕㄨㄏㄕㄌㄕ
給那年的自己=ㄍㄋㄋㄉㄗㄐ
格楊=ㄍㄧ
夜貓=ㄧㄇ
九張機=ㄐㄓㄐ
上海姑娘=ㄕㄏㄍㄋ
愛在夕陽下(純伴奏)=ㄞㄗㄒㄧㄒ(ㄔㄅㄗ)
時の扉=ㄕのㄈ
像我一樣=ㄒㄨㄧㄧ
電台情歌=ㄉㄊㄑㄍ
愛你的只有一個我=ㄞㄋㄉㄓㄧㄧㄍㄨ
千不該=ㄑㄅㄍ
像魚=ㄒㄩ
用心愛的人=ㄩㄒㄞㄉㄖ
一笑傾城=ㄧㄒㄑㄔ
水災=ㄕㄗ
好樂團=ㄏㄩㄊ
無數個我=ㄨㄕㄍㄨ
龍千玉,陳隨意=ㄌㄑㄩ,ㄔㄙㄧ
下輩子如果我還記得你=ㄒㄅㄗㄖㄍㄨㄏㄐㄉㄋ
任何環境不要懼怕=ㄖㄏㄏㄐㄅㄧㄐㄆ
?=?
大地回春=ㄉㄉㄏㄔ
我還相信我=ㄨㄏㄒㄒㄨ
楊芳儀,徐曉菁=ㄧㄈㄧ,ㄒㄒㄐ
齊秦=ㄑㄑ
倩影=ㄑㄧ
鄧見超=ㄉㄐㄔ
新年無限好=ㄒㄋㄨㄒㄏ
芒種(純伴奏)=ㄇㄓ(ㄔㄅㄗ)
天后=ㄊㄏ
今日=ㄐㄖ
愛情恰恰=ㄞㄑㄑㄑ
有形的翅膀=ㄧㄒㄉㄔㄅ
傷心藉口=ㄕㄒㄐㄎ
明天會更好=ㄇㄊㄏㄍㄏ
世界這麼大還是遇見你(純伴奏)=ㄕㄐㄓㄇㄉㄏㄕㄩㄐㄋ(ㄔㄅㄗ)
金罵沒ㄤ=ㄐㄇㄇㄤ
再起東山(純伴奏)=ㄗㄑㄉㄕ(ㄔㄅㄗ)
歸=ㄍ
愛丫愛丫(純伴奏)=ㄞㄧㄞㄧ(ㄔㄅㄗ)
流年=ㄌㄋ
癡情膽=ㄔㄑㄉ
聽媽媽的話=ㄊㄇㄇㄉㄏ
小房間=ㄒㄈㄐ
心將妳藏=ㄒㄐㄋㄘ
鹿港思帶路=ㄌㄍㄙㄉㄌ
我累了=ㄨㄌㄌ
劉德華=ㄌㄉㄏ
你不是說=ㄋㄅㄕㄕ
愛你的記誌=ㄞㄋㄉㄐㄓ
不要問我過得好不好=ㄅㄧㄨㄨㄍㄉㄏㄅㄏ
不願放你走=ㄅㄩㄈㄋㄗ
我為什麼那麼愛你=ㄨㄨㄕㄇㄋㄇㄞㄋ
不要害怕=ㄅㄧㄏㄆ
無所謂(純伴奏)=ㄨㄙㄨ(ㄔㄅㄗ)
鄭怡=ㄓㄧ
鹹酸甜=ㄒㄙㄊ
棉花糖=ㄇㄏㄊ
溫柔=ㄨㄖ
幾次=ㄐㄘ
品冠戴佩妮=ㄆㄍㄉㄆㄋ
種子=ㄓㄗ
李聖傑=ㄌㄕㄐ
醫治的愛=ㄧㄓㄉㄞ
結束開始=ㄐㄕㄎㄕ
聽說聽說=ㄊㄕㄊㄕ
我寫不出像樣的情歌=ㄨㄒㄅㄔㄒㄧㄉㄑㄍ
費翔朱樺=ㄈㄒㄓㄏ
男人女人=ㄋㄖㄋㄖ
倆倆相忘=ㄌㄌㄒㄨ
空港(純伴奏)=ㄎㄍ(ㄔㄅㄗ)
勇氣=ㄩㄑ
關於妳的歌=ㄍㄩㄋㄉㄍ
忘了所有=ㄨㄌㄙㄧ
蘇宥蓉=ㄙㄧㄖ
我應該得到=ㄨㄧㄍㄉㄉ
天堂有多遠(純伴奏)=ㄊㄊㄧㄉㄩ(ㄔㄅㄗ)
全國高中生大合唱=ㄑㄍㄍㄓㄕㄉㄏㄔ
吳淑敏=ㄨㄕㄇ
伍芝儀=ㄨㄓㄧ
摩天動物園=ㄇㄊㄉㄨㄩ
愛與哀愁=ㄞㄩㄞㄔ
爭戰的兵器=ㄓㄓㄉㄅㄑ
甩開=ㄕㄎ
我依然是我=ㄨㄧㄖㄕㄨ
愛情路口=ㄞㄑㄌㄎ
王傑=ㄨㄐ
哭了=ㄎㄌ
春花望露水(純伴奏)=ㄔㄏㄨㄌㄕ(ㄔㄅㄗ)
我是一隻魚=ㄨㄕㄧㄓㄩ
楊哲=ㄧㄓ
說到愛(純伴奏)=ㄕㄉㄞ(ㄔㄅㄗ)
蔣卓嘉=ㄐㄓㄐ
驚醒=ㄐㄒ
五木宏=ㄨㄇㄏ
路一直都在=ㄌㄧㄓㄉㄗ
,米津玄師=,ㄇㄐㄒㄕ
不是每個戀曲都有美好回憶=ㄅㄕㄇㄍㄌㄑㄉㄧㄇㄏㄏㄧ
與我常在=ㄩㄨㄔㄗ
快樂=ㄎㄌ
想念聖誕節=ㄒㄋㄕㄉㄐ
艾熱李佳隆=ㄞㄖㄌㄐㄌ
天黑請閉眼=ㄊㄏㄑㄅㄧ
小花=ㄒㄏ
蘇詩丁=ㄙㄕㄉ
怎麼開始忘了=ㄗㄇㄎㄕㄨㄌ
水中月圓=ㄕㄓㄩㄩ
朱興東=ㄓㄒㄉ
懸崖花=ㄒㄧㄏ
愛就是=ㄞㄐㄕ
天開了=ㄊㄎㄌ
怪咖=ㄍㄎ
á=á
生僻字(純伴奏)=ㄕㄆㄗ(ㄔㄅㄗ)
生命中不能承受之悲=ㄕㄇㄓㄅㄋㄔㄕㄓㄅ
張信哲=ㄓㄒㄓ
這樣愛你對不對=ㄓㄧㄞㄋㄉㄅㄉ
戒斷=ㄐㄉ
北一女中屆=ㄅㄧㄋㄓㄐ
圍庄=ㄨㄓ
嚴爵郭雪芙=ㄧㄐㄍㄒㄈ
謝雷=ㄒㄌ
女爵=ㄋㄐ
勉強幸福=ㄇㄑㄒㄈ
心花開(純伴奏)=ㄒㄏㄎ(ㄔㄅㄗ)
理智與感情=ㄌㄓㄩㄍㄑ
空笑夢(純伴奏)=ㄎㄒㄇ(ㄔㄅㄗ)
後來沒有你=ㄏㄌㄇㄧㄋ
噢買尬(純伴奏)=ㄩㄇㄍ(ㄔㄅㄗ)
女人純情夢=ㄋㄖㄔㄑㄇ
阿爸的便當=ㄚㄅㄉㄅㄉ
洗衣機=ㄒㄧㄐ
出賣=ㄔㄇ
林俊傑,蔡卓妍=ㄌㄐㄐ,ㄘㄓㄧ
分身有術=ㄈㄕㄧㄕ
未了情=ㄨㄌㄑ
陳乃榮=ㄔㄋㄖ
寵愛=ㄔㄞ
借一掛風=ㄐㄧㄍㄈ
小宇宙=ㄒㄩㄓ
那隻雞拜年=ㄋㄓㄐㄅㄋ
任意門=ㄖㄧㄇ
寂寞寂寞就好(純伴奏)=ㄐㄇㄐㄇㄐㄏ(ㄔㄅㄗ)
曾昱嘉=ㄘㄩㄐ
林俊吉戴梅君=ㄌㄐㄐㄉㄇㄐ
天天年輕=ㄊㄊㄋㄑ
來來來=ㄌㄌㄌ
你的樣子(純伴奏)=ㄋㄉㄧㄗ(ㄔㄅㄗ)
你還好嗎=ㄋㄏㄏㄇ
回憶的沙漏=ㄏㄧㄉㄕㄌ
夢中的愛(純伴奏)=ㄇㄓㄉㄞ(ㄔㄅㄗ)
聖靈請祢來=ㄕㄌㄑㄋㄌ
一半=ㄧㄅ
漂浪的海沙=ㄆㄌㄉㄏㄕ
再見=ㄗㄐ
靠山=ㄎㄕ
你好=ㄋㄏ
傻瓜=ㄕㄍ
一萬次悲傷=ㄧㄨㄘㄅㄕ
倒數=ㄉㄕ
我們能不能不分手=ㄨㄇㄋㄅㄋㄅㄈㄕ
小野花=ㄒㄧㄏ
花開富貴=ㄏㄎㄈㄍ
天然的最好=ㄊㄖㄉㄗㄏ
黑面=ㄏㄇ
時光話(純伴奏)=ㄕㄍㄏ(ㄔㄅㄗ)
一支小雨傘=ㄧㄓㄒㄩㄙ
蝴蝶=ㄏㄉ
$=$
趙泳鑫=ㄓㄩㄒ
你一定要幸福(純伴奏)=ㄋㄧㄉㄧㄒㄈ(ㄔㄅㄗ)
僕人的心=ㄆㄖㄉㄒ
哪裡來的勇氣=ㄋㄌㄌㄉㄩㄑ
上癮=ㄕㄧ
軟土深掘(純伴奏)=ㄖㄊㄕㄐ(ㄔㄅㄗ)
勿忘你=ㄨㄨㄋ
戀戀基隆山=ㄌㄌㄐㄌㄕ
為你痴情為你迷(純伴奏)=ㄨㄋㄔㄑㄨㄋㄇ(ㄔㄅㄗ)
夕陽無限好=ㄒㄧㄨㄒㄏ
蘭亭序=ㄌㄊㄒ
最後情人=ㄗㄏㄑㄖ
怎麼辦=ㄗㄇㄅ
煙火=ㄧㄏ
永彬,周延英=ㄩㄅ,ㄓㄧㄧ
心願便利貼=ㄒㄩㄅㄌㄊ
愛我你會死=ㄞㄨㄋㄏㄙ
婁峻碩=ㄌㄐㄕ
黑白配=ㄏㄅㄆ
千年等一回=ㄑㄋㄉㄧㄏ
肖戰=ㄒㄓ
其實=ㄑㄕ
不想讓你知道=ㄅㄒㄖㄋㄓㄉ
她的睫毛=ㄊㄉㄐㄇ
綿綿=ㄇㄇ
今天情人節=ㄐㄊㄑㄖㄐ
未了=ㄨㄌ
國境之南(純伴奏)=ㄍㄐㄓㄋ(ㄔㄅㄗ)
蒼白的記憶=ㄘㄅㄉㄐㄧ
我踏浪而來=ㄨㄊㄌㄦㄌ
小小蟲=ㄒㄒㄔ
情非得已(純伴奏)=ㄑㄈㄉㄧ(ㄔㄅㄗ)
對待你的愛=ㄉㄉㄋㄉㄞ
一點點喜歡=ㄧㄉㄉㄒㄏ
當冬夜漸暖=ㄉㄉㄧㄐㄋ
男性的純情(純伴奏)=ㄋㄒㄉㄔㄑ(ㄔㄅㄗ)
心不跳了=ㄒㄅㄊㄌ
背包客=ㄅㄅㄎ
一直給=ㄧㄓㄍ
就是愛你=ㄐㄕㄞㄋ
學貓叫(純伴奏)=ㄒㄇㄐ(ㄔㄅㄗ)
酒醉的探戈=ㄐㄗㄉㄊㄍ
一念之間=ㄧㄋㄓㄐ
花期=ㄏㄑ
列車=ㄌㄔ
東風破=ㄉㄈㄆ
菅田将暉=ㄐㄊㄐㄏ
紅顏=ㄏㄧ
好酒好兄弟=ㄏㄐㄏㄒㄉ
（故得證）=（ㄍㄉㄓ）
任然=ㄖㄖ
秋天别来=ㄑㄊ别ㄌ
熊仔,豹子膽=ㄒㄗ,ㄅㄗㄉ
想起=ㄒㄑ
此刻你聽好了=ㄘㄎㄋㄊㄏㄌ
那些年=ㄋㄒㄋ
忍者=ㄖㄓ
別人的=ㄅㄖㄉ
白色婚禮=ㄅㄙㄏㄌ
情人知己=ㄑㄖㄓㄐ
怎樣=ㄗㄧ
我還是愛著你(純伴奏)=ㄨㄏㄕㄞㄓㄋ(ㄔㄅㄗ)
有夢一路陪=ㄧㄇㄧㄌㄆ
新的心跳(純伴奏)=ㄒㄉㄒㄊ(ㄔㄅㄗ)
不得不愛(純伴奏)=ㄅㄉㄅㄞ(ㄔㄅㄗ)
是否你曾偷偷的哭=ㄕㄈㄋㄘㄊㄊㄉㄎ
知否知否(純伴奏)=ㄓㄈㄓㄈ(ㄔㄅㄗ)
帶我進入祢的同在=ㄉㄨㄐㄖㄋㄉㄊㄗ
濃妝=ㄋㄓ
靠近=ㄎㄐ
飯隨愛人=ㄈㄙㄞㄖ
不知好歹=ㄅㄓㄏㄉ
濛濛春雨=ㄇㄇㄔㄩ
姑娘=ㄍㄋ
愛的就是你=ㄞㄉㄐㄕㄋ
兵變=ㄅㄅ
距離=ㄐㄌ
吳宗憲溫嵐=ㄨㄗㄒㄨㄌ
我有我愛你=ㄨㄧㄨㄞㄋ
廣島之戀(純伴奏)=ㄍㄉㄓㄌ(ㄔㄅㄗ)
八三夭,玖壹壹=ㄅㄙㄧ,ㄐㄧㄧ
北極光=ㄅㄐㄍ
永晝=ㄩㄓ
無眠=ㄨㄇ
數到三,一起放手=ㄕㄉㄙ,ㄧㄑㄈㄕ
越走越勇=ㄩㄗㄩㄩ
美麗=ㄇㄌ
失約=ㄕㄩ
人生的歌(純伴奏)=ㄖㄕㄉㄍ(ㄔㄅㄗ)
對我好一點=ㄉㄨㄏㄧㄉ
孫盛希,魏如萱=ㄙㄕㄒ,ㄨㄖㄒ
羅志祥,楊丞琳=ㄌㄓㄒ,ㄧㄔㄌ
別丟下我不管=ㄅㄉㄒㄨㄅㄍ
陳冰=ㄔㄅ
風風雨雨作陣行=ㄈㄈㄩㄩㄗㄓㄒ
許景淳=ㄒㄐㄔ
風和日麗=ㄈㄏㄖㄌ
心裡有鬼=ㄒㄌㄧㄍ
葉懷佩=ㄧㄏㄆ
手中戲=ㄕㄓㄒ
把你信仰=ㄅㄋㄒㄧ
愛在夏天(純伴奏)=ㄞㄗㄒㄊ(ㄔㄅㄗ)
我還是不懂(純伴奏)=ㄨㄏㄕㄅㄉ(ㄔㄅㄗ)
是愛=ㄕㄞ
心事(純伴奏)=ㄒㄕ(ㄔㄅㄗ)
用心良苦=ㄩㄒㄌㄎ
踏破鐵鞋=ㄊㄆㄊㄒ
抉擇=ㄐㄗ
大象=ㄉㄒ
可以了=ㄎㄧㄌ
你怎麼捨得我難過=ㄋㄗㄇㄕㄉㄨㄋㄍ
陳奕迅,王菲=ㄔㄧㄒ,ㄨㄈ
幸福了然後呢=ㄒㄈㄌㄖㄏㄋ
逃=ㄊ
記念=ㄐㄋ
無條件=ㄨㄊㄐ
黛玉=ㄉㄩ
身後(純伴奏)=ㄕㄏ(ㄔㄅㄗ)
你最珍貴=ㄋㄗㄓㄍ
無情的人不是我=ㄨㄑㄉㄖㄅㄕㄨ
誰人了解我=ㄕㄖㄌㄐㄨ
放逐=ㄈㄓ
小幸運(純伴奏)=ㄒㄒㄩ(ㄔㄅㄗ)
李行亮=ㄌㄒㄌ
馬甲上的繩索=ㄇㄐㄕㄉㄕㄙ
鳳凰花開的路口=ㄈㄏㄏㄎㄉㄌㄎ
大張偉=ㄉㄓㄨ
兄弟你說(純伴奏)=ㄒㄉㄋㄕ(ㄔㄅㄗ)
黃明志蕭敬騰=ㄏㄇㄓㄒㄐㄊ
雲中月圓(純伴奏)=ㄩㄓㄩㄩ(ㄔㄅㄗ)
好東西=ㄏㄉㄒ
類似愛情=ㄌㄙㄞㄑ
黃明志,發財寶=ㄏㄇㄓ,ㄈㄘㄅ
葉憲修=ㄧㄒㄒ
陸曉丹=ㄌㄒㄉ
胡歌=ㄏㄍ
神魂顛倒=ㄕㄏㄉㄉ
李玖哲=ㄌㄐㄓ
什麼時候=ㄕㄇㄕㄏ
吹吹風=ㄔㄔㄈ
飛鳥和她=ㄈㄋㄏㄊ
我不想改變世界我只想不被世界改變=ㄨㄅㄒㄍㄅㄕㄐㄨㄓㄒㄅㄅㄕㄐㄍㄅ
楊凱凱錢欣郁馬君珮=ㄧㄎㄎㄑㄒㄩㄇㄐㄆ
錯過不錯=ㄘㄍㄅㄘ
吳亦凡=ㄨㄧㄈ
刻痕=ㄎㄏ
雪落下的聲音=ㄒㄌㄒㄉㄕㄧ
耶和華沙龍=ㄧㄏㄏㄕㄌ
身騎白馬(純伴奏)=ㄕㄑㄅㄇ(ㄔㄅㄗ)
櫻桃姐姐=ㄧㄊㄐㄐ
不怕不怕=ㄅㄆㄅㄆ
元若藍=ㄩㄖㄌ
新娘車=ㄒㄋㄔ
只有你知道=ㄓㄧㄋㄓㄉ
蔡健雅,孫燕姿=ㄘㄐㄧ,ㄙㄧㄗ
傷心夜港邊=ㄕㄒㄧㄍㄅ
我不配(純伴奏)=ㄨㄅㄆ(ㄔㄅㄗ)
超跑情人夢(純伴奏)=ㄔㄆㄑㄖㄇ(ㄔㄅㄗ)
每一天=ㄇㄧㄊ
孫耀威=ㄙㄧㄨ
西海情歌(純伴奏)=ㄒㄏㄑㄍ(ㄔㄅㄗ)
你離開他了嗎=ㄋㄌㄎㄊㄌㄇ
多情兄=ㄉㄑㄒ
兩隻戀人=ㄌㄓㄌㄖ
八卦=ㄅㄍ
犟=犟
穀雨(純伴奏)=ㄍㄩ(ㄔㄅㄗ)
手中情(純伴奏)=ㄕㄓㄑ(ㄔㄅㄗ)
孤單心事=ㄍㄉㄒㄕ
我好像在哪見過你=ㄨㄏㄒㄗㄋㄐㄍㄋ
為你=ㄨㄋ
尋人啟事=ㄒㄖㄑㄕ
時間仍然繼續在走=ㄕㄐㄖㄖㄐㄒㄗㄗ
全年無休=ㄑㄋㄨㄒ
李婭莎=ㄌㄧㄙ
金盞花=ㄐㄓㄏ
刀郎雲朵王翰儀=ㄉㄌㄩㄉㄨㄏㄧ
也罷=ㄧㄅ
潛規則=ㄑㄍㄗ
就別愛我=ㄐㄅㄞㄨ
我心中尚未崩壞的地方=ㄨㄒㄓㄕㄨㄅㄏㄉㄉㄈ
花香=ㄏㄒ
春夏秋冬(純伴奏)=ㄔㄒㄑㄉ(ㄔㄅㄗ)
朋友別哭(純伴奏)=ㄆㄧㄅㄎ(ㄔㄅㄗ)
吳晉淮=ㄨㄐㄏ
謝和弦,張智成=ㄒㄏㄒ,ㄓㄓㄔ
想一個男生=ㄒㄧㄍㄋㄕ
等著等著就老了=ㄉㄓㄉㄓㄐㄌㄌ
錯了再錯=ㄘㄌㄗㄘ
原諒=ㄩㄌ
最傷心是誰=ㄗㄕㄒㄕㄕ
迷人的危險=ㄇㄖㄉㄨㄒ
你的樣子=ㄋㄉㄧㄗ
忠孝東路走九遍=ㄓㄒㄉㄌㄗㄐㄅ
崇拜=ㄔㄅ
惜別的海岸=ㄒㄅㄉㄏㄢ
分手看看=ㄈㄕㄎㄎ
也許明天=ㄧㄒㄇㄊ
小步舞曲=ㄒㄅㄨㄑ
又見小雨=ㄧㄐㄒㄩ
天下無雙(純伴奏)=ㄊㄒㄨㄕ(ㄔㄅㄗ)
想你想你=ㄒㄋㄒㄋ
逆時光的浪=ㄋㄕㄍㄉㄌ
何時再相會=ㄏㄕㄗㄒㄏ
化裝舞會=ㄏㄓㄨㄏ
此生愛祢不渝=ㄘㄕㄞㄋㄅㄩ
皆可(純伴奏)=ㄐㄎ(ㄔㄅㄗ)
境外=ㄐㄨ
位置=ㄨㄓ
永彬,楊佬叁=ㄩㄅ,ㄧㄌ叁
山頂黑狗兄=ㄕㄉㄏㄍㄒ
康定情歌(純伴奏)=ㄎㄉㄑㄍ(ㄔㄅㄗ)
有一種悲傷=ㄧㄧㄓㄅㄕ
黃路梓茵=ㄏㄌㄗㄧ
悟空=ㄨㄎ
那英=ㄋㄧ
周興哲,楊凱琳=ㄓㄒㄓ,ㄧㄎㄌ
有人在等我=ㄧㄖㄗㄉㄨ
重傷=ㄓㄕ
一眼萬年=ㄧㄧㄨㄋ
無限=ㄨㄒ
搞笑=ㄍㄒ
全日愛(純伴奏)=ㄑㄖㄞ(ㄔㄅㄗ)
大台風樂團=ㄉㄊㄈㄩㄊ
韓寶儀=ㄏㄅㄧ
心事誰人知=ㄒㄕㄕㄖㄓ
你，有沒有過=ㄋ，ㄧㄇㄧㄍ
心內的雨=ㄒㄋㄉㄩ
夜夜夢=ㄧㄧㄇ
懷念的花籃燈=ㄏㄋㄉㄏㄌㄉ
我知道你很難過(純伴奏)=ㄨㄓㄉㄋㄏㄋㄍ(ㄔㄅㄗ)
肯周樂隊引擎=ㄎㄓㄩㄉㄧㄑ
一把無情鹽(純伴奏)=ㄧㄅㄨㄑㄧ(ㄔㄅㄗ)
看見自己=ㄎㄐㄗㄐ
神荼=ㄕㄊ
夢想啟動=ㄇㄒㄑㄉ
你心如鐵=ㄋㄒㄖㄊ
人生看頭前=ㄖㄕㄎㄊㄑ
魔幻力量陳信宏=ㄇㄏㄌㄌㄔㄒㄏ
我無所謂(純伴奏)=ㄨㄨㄙㄨ(ㄔㄅㄗ)
許多年以後(純伴奏)=ㄒㄉㄋㄧㄏ(ㄔㄅㄗ)
田園=ㄊㄩ
艷火=ㄧㄏ
還好(純伴奏)=ㄏㄏ(ㄔㄅㄗ)
靈魂的重量=ㄌㄏㄉㄓㄌ
遇見未來=ㄩㄐㄨㄌ
你會怎麼記得我=ㄋㄏㄗㄇㄐㄉㄨ
心跳=ㄒㄊ
周杰倫梁心頤=ㄓㄐㄌㄌㄒㄧ
到這年紀=ㄉㄓㄋㄐ
快樂崇拜=ㄎㄌㄔㄅ
幸福不滅=ㄒㄈㄅㄇ
快魚仔=ㄎㄩㄗ
夢寐以求=ㄇㄇㄧㄑ
爆米花的味道=ㄅㄇㄏㄉㄨㄉ
尋人啟事(純伴奏)=ㄒㄖㄑㄕ(ㄔㄅㄗ)
一生等待你=ㄧㄕㄉㄉㄋ
第二次分手(純伴奏)=ㄉㄦㄘㄈㄕ(ㄔㄅㄗ)
下一個男人也許會更好=ㄒㄧㄍㄋㄖㄧㄒㄏㄍㄏ
紀曉君=ㄐㄒㄐ
磅見的人=ㄅㄐㄉㄖ
車站(純伴奏)=ㄔㄓ(ㄔㄅㄗ)
鄉愁=ㄒㄔ
任我行(純伴奏)=ㄖㄨㄒ(ㄔㄅㄗ)
逆時光的浪(純伴奏)=ㄋㄕㄍㄉㄌ(ㄔㄅㄗ)
海洋=ㄏㄧ
追光者(純伴奏)=ㄓㄍㄓ(ㄔㄅㄗ)
男人不該讓女人流淚=ㄋㄖㄅㄍㄖㄋㄖㄌㄌ
孤鸞命=ㄍㄌㄇ
歹逗陣=ㄉㄉㄓ
邰正宵姚可傑=ㄊㄓㄒㄧㄎㄐ
黃宥傑=ㄏㄧㄐ
離開我=ㄌㄎㄨ
好想你=ㄏㄒㄋ
圈兒詞=ㄑㄦㄘ
阿涵=ㄚㄏ
心頭肉(純伴奏)=ㄒㄊㄖ(ㄔㄅㄗ)
癡心等待你=ㄔㄒㄉㄉㄋ
少年(純伴奏)=ㄕㄋ(ㄔㄅㄗ)
錯的人=ㄘㄉㄖ
煙花(純伴奏)=ㄧㄏ(ㄔㄅㄗ)
稻香=ㄉㄒ
陪你看星星=ㄆㄋㄎㄒㄒ
下山=ㄒㄕ
今夜唱甚麼歌=ㄐㄧㄔㄕㄇㄍ
劉至佳=ㄌㄓㄐ
情淚=ㄑㄌ
陪你=ㄆㄋ
庾澄慶=ㄩㄔㄑ
蘇霈=ㄙㄆ
我也不想這樣=ㄨㄧㄅㄒㄓㄧ
天使的禮物=ㄊㄕㄉㄌㄨ
五月天阿信=ㄨㄩㄊㄚㄒ
蹺蹺板=ㄑㄑㄅ
異鄉之戀=ㄧㄒㄓㄌ
信心花舍=ㄒㄒㄏㄕ
因為愛所以愛=ㄧㄨㄞㄙㄧㄞ
傅如喬=ㄈㄖㄑ
思念到何時=ㄙㄋㄉㄏㄕ
弦子=ㄒㄗ
咱的一生咱的愛(純伴奏)=ㄗㄉㄧㄕㄗㄉㄞ(ㄔㄅㄗ)
寂寞飛行=ㄐㄇㄈㄒ
淋雨中=ㄌㄩㄓ
憑什麼(純伴奏)=ㄆㄕㄇ(ㄔㄅㄗ)
最後的風度(純伴奏)=ㄗㄏㄉㄈㄉ(ㄔㄅㄗ)
斷點=ㄉㄉ
不如歸去=ㄅㄖㄍㄑ
嗚哇嗚=ㄨㄨㄨ
蟑螂小強=ㄓㄌㄒㄑ
王子的新衣=ㄨㄗㄉㄒㄧ
情歌=ㄑㄍ
痴情不願醒=ㄔㄑㄅㄩㄒ
以後別做朋友=ㄧㄏㄅㄗㄆㄧ
插曲=ㄔㄑ
陶喆,蔡依林=ㄊㄓ,ㄘㄧㄌ
等你下課(純伴奏)=ㄉㄋㄒㄎ(ㄔㄅㄗ)
吳俊宏,朱海君=ㄨㄐㄏ,ㄓㄏㄐ
選擇(純伴奏)=ㄒㄗ(ㄔㄅㄗ)
多情的我無情的你=ㄉㄑㄉㄨㄨㄑㄉㄋ
無人願愛我(純伴奏)=ㄨㄖㄩㄞㄨ(ㄔㄅㄗ)
遇到(純伴奏)=ㄩㄉ(ㄔㄅㄗ)
小毛驢=ㄒㄇㄌ
為你平定的天下=ㄨㄋㄆㄉㄉㄊㄒ
風雨無阻=ㄈㄩㄨㄗ
那個誰=ㄋㄍㄕ
冬季到台北來看雨=ㄉㄐㄉㄊㄅㄌㄎㄩ
啞巴(純伴奏)=ㄧㄅ(ㄔㄅㄗ)
李唯楓=ㄌㄨㄈ
曾惜=ㄘㄒ
女團=ㄋㄊ
蘇芮=ㄙㄖ
讚美之泉=ㄗㄇㄓㄑ
別找我麻煩=ㄅㄓㄨㄇㄈ
人生沒有如果=ㄖㄕㄇㄧㄖㄍ
草爺,梅海強=ㄘㄧ,ㄇㄏㄑ
舊夢一場(純伴奏)=ㄐㄇㄧㄔ(ㄔㄅㄗ)
俞隆華=ㄩㄌㄏ
離開我的依賴=ㄌㄎㄨㄉㄧㄌ
葬心=ㄗㄒ
然後你怎麼說=ㄖㄏㄋㄗㄇㄕ
我真的以為=ㄨㄓㄉㄧㄨ
依然愛你=ㄧㄖㄞㄋ
說不出的味道=ㄕㄅㄔㄉㄨㄉ
單行的軌道=ㄉㄒㄉㄍㄉ
說走就走=ㄕㄗㄐㄗ
王識賢=ㄨㄕㄒ
懦夫=ㄋㄈ
聞人聽書=ㄨㄖㄊㄕ
只有我的天空有烏雲(純伴奏)=ㄓㄧㄨㄉㄊㄎㄧㄨㄩ(ㄔㄅㄗ)
心的方向(純伴奏)=ㄒㄉㄈㄒ(ㄔㄅㄗ)
少了一件牛仔褲=ㄕㄌㄧㄐㄋㄗㄎ
綠色=ㄌㄙ
半暝的目屎=ㄅㄇㄉㄇㄕ
不習慣喊痛=ㄅㄒㄍㄏㄊ
笑忘歌=ㄒㄨㄍ
,小宇=,ㄒㄩ
天雷地火=ㄊㄌㄉㄏ
一杯起=ㄧㄅㄑ
明日又天涯=ㄇㄖㄧㄊㄧ
不好說=ㄅㄏㄕ
安心亞,羅志祥=ㄢㄒㄧ,ㄌㄓㄒ
羅力威=ㄌㄌㄨ
張若凡=ㄓㄖㄈ
木蘭情=ㄇㄌㄑ
真的我=ㄓㄉㄨ
小情歌(純伴奏)=ㄒㄑㄍ(ㄔㄅㄗ)
蘇打綠,陳嘉樺=ㄙㄉㄌ,ㄔㄐㄏ
早熟=ㄗㄕ
輸了你贏了世界又如何(純伴奏)=ㄕㄌㄋㄧㄌㄕㄐㄧㄖㄏ(ㄔㄅㄗ)
聽說你要走=ㄊㄕㄋㄧㄗ
黃小琥=ㄏㄒㄏ
終於說出口=ㄓㄩㄕㄔㄎ
器皿禱告音樂分享事工=ㄑㄇㄉㄍㄧㄩㄈㄒㄕㄍ
易烊千璽=ㄧㄧㄑㄒ
下一個天亮=ㄒㄧㄍㄊㄌ
摸著主的禱告=ㄇㄓㄓㄉㄉㄍ
聖誕結=ㄕㄉㄐ
我愛我=ㄨㄞㄨ
這款=ㄓㄎ
利綺=ㄌㄑ
海生=ㄏㄕ
愛情廢柴=ㄞㄑㄈㄔ
我不是你的觀賞魚=ㄨㄅㄕㄋㄉㄍㄕㄩ
望月想你=ㄨㄩㄒㄋ
你還愛我嗎=ㄋㄏㄞㄨㄇ
巴兩個啊乎我清醒=ㄅㄌㄍㄚㄏㄨㄑㄒ
傻子(純伴奏)=ㄕㄗ(ㄔㄅㄗ)
山茶花(純伴奏)=ㄕㄔㄏ(ㄔㄅㄗ)
哪裡是你的擁抱=ㄋㄌㄕㄋㄉㄩㄅ
真心的愛=ㄓㄒㄉㄞ
山歌=ㄕㄍ
紅線=ㄏㄒ
離開後(純伴奏)=ㄌㄎㄏ(ㄔㄅㄗ)
心地=ㄒㄉ
落葉歸根(純伴奏)=ㄌㄧㄍㄍ(ㄔㄅㄗ)
你到底愛誰=ㄋㄉㄉㄞㄕ
讓我逃離平庸的生活(純伴奏)=ㄖㄨㄊㄌㄆㄩㄉㄕㄏ(ㄔㄅㄗ)
曲終人散=ㄑㄓㄖㄙ
瓶中沙=ㄆㄓㄕ
你那邊是晴天=ㄋㄋㄅㄕㄑㄊ
信徒=ㄒㄊ
我是一片雲=ㄨㄕㄧㄆㄩ
長大=ㄓㄉ
良山=ㄌㄕ
代替=ㄉㄊ
楊宗緯=ㄧㄗㄨ
美杜莎=ㄇㄉㄙ
北京=ㄅㄐ
非同兒戲=ㄈㄊㄦㄒ
忘記你不如忘記自己=ㄨㄐㄋㄅㄖㄨㄐㄗㄐ
林禹勝=ㄌㄩㄕ
反義詞(純伴奏)=ㄈㄧㄘ(ㄔㄅㄗ)
終於了解自由=ㄓㄩㄌㄐㄗㄧ
開到荼蘼=ㄎㄉㄊㄇ
鏗鏘玫瑰=ㄎㄑㄇㄍ
剛澤斌=ㄍㄗㄅ
伍佰萬芳=ㄨㄅㄨㄈ
大江東去=ㄉㄐㄉㄑ
愛那麼痛=ㄞㄋㄇㄊ
潮来笠=ㄔㄌㄌ
手掌心=ㄕㄓㄒ
新地球=ㄒㄉㄑ
脆樂團=ㄘㄩㄊ
好想好想=ㄏㄒㄏㄒ
因為所以=ㄧㄨㄙㄧ
追光者=ㄓㄍㄓ
愛過就可以=ㄞㄍㄐㄎㄧ
信徒(純伴奏)=ㄒㄊ(ㄔㄅㄗ)
更好的我們=ㄍㄏㄉㄨㄇ
時光倒流=ㄕㄍㄉㄌ
無你就無我=ㄨㄋㄐㄨㄨ
牛奶麵包=ㄋㄋㄇㄅ
季彥霖=ㄐㄧㄌ
讓我留在你身邊(純伴奏)=ㄖㄨㄌㄗㄋㄕㄅ(ㄔㄅㄗ)
劉宗立曾佩媛陳淑惠=ㄌㄗㄌㄘㄆㄩㄔㄕㄏ
來去紅塵=ㄌㄑㄏㄔ
喜歡寂寞=ㄒㄏㄐㄇ
曾靜玟=ㄘㄐㄨ
張惠妹,艾怡良,徐佳瑩=ㄓㄏㄇ,ㄞㄧㄌ,ㄒㄐㄧ
夜=ㄧ
水姑娘=ㄕㄍㄋ
娜奴娃情歌=ㄋㄋㄨㄑㄍ
一筆勾銷=ㄧㄅㄍㄒ
紅模仿=ㄏㄇㄈ
單身孤影=ㄉㄕㄍㄧ
阿公的茶=ㄚㄍㄉㄔ
靚妹仔=ㄐㄇㄗ
領悟=ㄌㄨ
我心旋律=ㄨㄒㄒㄌ
下雨天=ㄒㄩㄊ
聚散兩依依=ㄐㄙㄌㄧㄧ
江美麗=ㄐㄇㄌ
衣櫥的秘密=ㄧㄔㄉㄇㄇ
半陽=ㄅㄧ
等待=ㄉㄉ
姨仔(純伴奏)=ㄧㄗ(ㄔㄅㄗ)
浮沙之路=ㄈㄕㄓㄌ
歡喜才通醉=ㄏㄒㄘㄊㄗ
夢中的蝴蝶=ㄇㄓㄉㄏㄉ
極大的聲音=ㄐㄉㄉㄕㄧ
跨時代=ㄎㄕㄉ
為你打拼=ㄨㄋㄉㄆ
傷心農場=ㄕㄒㄋㄔ
曾經美麗過=ㄘㄐㄇㄌㄍ
無情的情書=ㄨㄑㄉㄑㄕ
來去夏威夷=ㄌㄑㄒㄨㄧ
é=é
等你等到我心痛=ㄉㄋㄉㄉㄨㄒㄊ
目及皆是你(純伴奏)=ㄇㄐㄐㄕㄋ(ㄔㄅㄗ)
眉間雪=ㄇㄐㄒ
故事的角色=ㄍㄕㄉㄐㄙ
芊芊=ㄑㄑ
謝震廷徐靖玟=ㄒㄓㄊㄒㄐㄨ
楊芸晴=ㄧㄩㄑ
吳宗憲,溫嵐=ㄨㄗㄒ,ㄨㄌ
你是愛我的(純伴奏)=ㄋㄕㄞㄨㄉ(ㄔㄅㄗ)
張信哲,于台煙=ㄓㄒㄓ,ㄩㄊㄧ
那些花兒=ㄋㄒㄏㄦ
離人愁=ㄌㄖㄔ
你冷得像風(純伴奏)=ㄋㄌㄉㄒㄈ(ㄔㄅㄗ)
偉晉=ㄨㄐ
林子祥=ㄌㄗㄒ
真實故事改編=ㄓㄕㄍㄕㄍㄅ
怎麼說我不愛你=ㄗㄇㄕㄨㄅㄞㄋ
酒後的心聲(純伴奏)=ㄐㄏㄉㄒㄕ(ㄔㄅㄗ)
露水情緣=ㄌㄕㄑㄩ
菲道爾=ㄈㄉㄦ
我比從前想你了=ㄨㄅㄘㄑㄒㄋㄌ
天韻合唱團=ㄊㄩㄏㄔㄊ
叫阮的名=ㄐㄖㄉㄇ
一千個晚安(純伴奏)=ㄧㄑㄍㄨㄢ(ㄔㄅㄗ)
é法蘭黛樂團=éㄈㄌㄉㄩㄊ
心碎的聲=ㄒㄙㄉㄕ
香水=ㄒㄕ
洪榮宏=ㄏㄖㄏ
打勾勾=ㄉㄍㄍ
愛情轉移=ㄞㄑㄓㄧ
送我玫瑰花=ㄙㄨㄇㄍㄏ
你並不懂我=ㄋㄅㄅㄉㄨ
井朧=ㄐㄌ
我又想起你=ㄨㄧㄒㄑㄋ
猜心=ㄘㄒ
就讓我像個孩子一樣=ㄐㄖㄨㄒㄍㄏㄗㄧㄧ
媽媽不免驚=ㄇㄇㄅㄇㄐ
當我的好朋友=ㄉㄨㄉㄏㄆㄧ
水車姑娘=ㄕㄔㄍㄋ
熱狗艾怡良=ㄖㄍㄞㄧㄌ
蔡幸娟=ㄘㄒㄐ
下一次擁抱=ㄒㄧㄘㄩㄅ
光年之外(純伴奏)=ㄍㄋㄓㄨ(ㄔㄅㄗ)
孫盛希,=ㄙㄕㄒ,
黎明不要來=ㄌㄇㄅㄧㄌ
珍惜=ㄓㄒ
,艾怡良=,ㄞㄧㄌ
情難枕=ㄑㄋㄓ
聽見下雨的聲音=ㄊㄐㄒㄩㄉㄕㄧ
咱的天=ㄗㄉㄊ
海上花=ㄏㄕㄏ
不是因為寂寞才想你=ㄅㄕㄧㄨㄐㄇㄘㄒㄋ
張雨生,張惠妹=ㄓㄩㄕ,ㄓㄏㄇ
你的酒館對我打了烊(純伴奏)=ㄋㄉㄐㄍㄉㄨㄉㄌㄧ(ㄔㄅㄗ)
想哭=ㄒㄎ
擱淺(純伴奏)=ㄍㄑ(ㄔㄅㄗ)
一芯三葉=ㄧㄒㄙㄧ
不要驚動愛情=ㄅㄧㄐㄉㄞㄑ
藍心湄=ㄌㄒㄇ
我才沒有那樣呢=ㄨㄘㄇㄧㄋㄧㄋ
說到愛=ㄕㄉㄞ
星球墜落=ㄒㄑㄓㄌ
周柏豪=ㄓㄅㄏ
還愛著你=ㄏㄞㄓㄋ
認真的雪=ㄖㄓㄉㄒ
紅蓮華=ㄏㄌㄏ
又是黃昏(純伴奏)=ㄧㄕㄏㄏ(ㄔㄅㄗ)
天涯=ㄊㄧ
我最親愛的=ㄨㄗㄑㄞㄉ
問流星=ㄨㄌㄒ
落花成泥=ㄌㄏㄔㄋ
太多=ㄊㄉ
放手去做(純伴奏)=ㄈㄕㄑㄗ(ㄔㄅㄗ)
飛輪海=ㄈㄌㄏ
南西肯恩=ㄋㄒㄎㄣ
一萬次悲傷(純伴奏)=ㄧㄨㄘㄅㄕ(ㄔㄅㄗ)
歌之王(粵語)=ㄍㄓㄨ(ㄩㄩ)
戴愛玲,=ㄉㄞㄌ,
隱形的紀念=ㄧㄒㄉㄐㄋ
最久的瞬間=ㄗㄐㄉㄕㄐ
\永不放棄=\ㄩㄅㄈㄑ
你一個人我一個人=ㄋㄧㄍㄖㄨㄧㄍㄖ
再見之前=ㄗㄐㄓㄑ
偷哭的日子=ㄊㄎㄉㄖㄗ
總是那麼傻=ㄗㄕㄋㄇㄕ
先生有事嗎?=ㄒㄕㄧㄕㄇ?
王若琳=ㄨㄖㄌ
屠洪刚=ㄊㄏㄍ
抱擁這分鐘=ㄅㄩㄓㄈㄓ
鴛鴦溪=ㄩㄧㄒ
是我太軟心=ㄕㄨㄊㄖㄒ
走心=ㄗㄒ
就是喜歡你=ㄐㄕㄒㄏㄋ
若你碰到他=ㄖㄋㄆㄉㄊ
相思淚痕=ㄒㄙㄌㄏ
到不了的地方=ㄉㄅㄌㄉㄉㄈ
柯有倫林明禎=ㄎㄧㄌㄌㄇㄓ
後來後來(純伴奏)=ㄏㄌㄏㄌ(ㄔㄅㄗ)
再一次擁有=ㄗㄧㄘㄩㄧ
方宥心=ㄈㄧㄒ
情一動心就痛=ㄑㄧㄉㄒㄐㄊ
夜總會=ㄧㄗㄏ
陳凱詠=ㄔㄎㄩ
思念在飛=ㄙㄋㄗㄈ
許願=ㄒㄩ
浜圭介,桂銀淑=浜ㄍㄐ,ㄍㄧㄕ
模範情書=ㄇㄈㄑㄕ
周湯豪=ㄓㄊㄏ
拜年=ㄅㄋ
我要你(純伴奏)=ㄨㄧㄋ(ㄔㄅㄗ)
趙又廷=ㄓㄧㄊ
康康=ㄎㄎ
你敢我就敢=ㄋㄍㄨㄐㄍ
安平之戀=ㄢㄆㄓㄌ
我不祝福=ㄨㄅㄓㄈ
差一步(純伴奏)=ㄔㄧㄅ(ㄔㄅㄗ)
夕陽伴我歸=ㄒㄧㄅㄨㄍ
阿刁=ㄚㄉ
三國戀=ㄙㄍㄌ
小飛俠=ㄒㄈㄒ
很久以後(純伴奏)=ㄏㄐㄧㄏ(ㄔㄅㄗ)
隱形的翅膀=ㄧㄒㄉㄔㄅ
哭砂=ㄎㄕ
陳百潭=ㄔㄅㄊ
速配程度=ㄙㄆㄔㄉ
不愛你愛誰=ㄅㄞㄋㄞㄕ
陳柯宇=ㄔㄎㄩ
紀家盈,以莉·高露,舒米恩=ㄐㄐㄧ,ㄧㄌ·ㄍㄌ,ㄕㄇㄣ
放心不下=ㄈㄒㄅㄒ
蟬想=ㄔㄒ
傻子=ㄕㄗ
久等了=ㄐㄉㄌ
許嵩=ㄒㄙ
我想你了=ㄨㄒㄋㄌ
再愛我一天=ㄗㄞㄨㄧㄊ
我想我是海=ㄨㄒㄨㄕㄏ
武裝的薔薇=ㄨㄓㄉㄑㄨ
一夜情=ㄧㄧㄑ
浮誇(純伴奏)=ㄈㄎ(ㄔㄅㄗ)
不難(純伴奏)=ㄅㄋ(ㄔㄅㄗ)
漂向北方=ㄆㄒㄅㄈ
津軽海峽冬景色=ㄐ軽ㄏㄒㄉㄐㄙ
阿吉仔=ㄚㄐㄗ
蔡依林=ㄘㄧㄌ
說說臉=ㄕㄕㄌ
馬郁=ㄇㄩ
問韓信=ㄨㄏㄒ
或對或錯=ㄏㄉㄏㄘ
家家酒=ㄐㄐㄐ
用生命所愛的人(純伴奏)=ㄩㄕㄇㄙㄞㄉㄖ(ㄔㄅㄗ)
最真的夢=ㄗㄓㄉㄇ
謝謝儂=ㄒㄒㄋ
千年夢=ㄑㄋㄇ
當你(純伴奏)=ㄉㄋ(ㄔㄅㄗ)
夢中的情話=ㄇㄓㄉㄑㄏ
呂建中,任家萱=ㄌㄐㄓ,ㄖㄐㄒ
短髮=ㄉㄈ
紙雨傘=ㄓㄩㄙ
萬沙浪=ㄨㄕㄌ
火箭少女=ㄏㄐㄕㄋ
女人的青春=ㄋㄖㄉㄑㄔ
失去=ㄕㄑ
春分=ㄔㄈ
給他=ㄍㄊ
兄弟你說=ㄒㄉㄋㄕ
從來沒愛過=ㄘㄌㄇㄞㄍ
我把我的青春給你=ㄨㄅㄨㄉㄑㄔㄍㄋ
林中鳥=ㄌㄓㄋ
歡喜來做伙=ㄏㄒㄌㄗㄏ
風流阿狗兄(純伴奏)=ㄈㄌㄚㄍㄒ(ㄔㄅㄗ)
心承諾=ㄒㄔㄋ
人生公路(純伴奏)=ㄖㄕㄍㄌ(ㄔㄅㄗ)
看見妳的聲音=ㄎㄐㄋㄉㄕㄧ
差不多姑娘(純伴奏)=ㄔㄅㄉㄍㄋ(ㄔㄅㄗ)
珊瑚海(純伴奏)=ㄕㄏㄏ(ㄔㄅㄗ)
還不夠遠=ㄏㄅㄍㄩ
傷心的人別聽慢歌=ㄕㄒㄉㄖㄅㄊㄇㄍ
壞與更壞=ㄏㄩㄍㄏ
太陽星辰(純伴奏)=ㄊㄧㄒㄔ(ㄔㄅㄗ)
輪迴(純伴奏)=ㄌㄏ(ㄔㄅㄗ)
明天也要作伴=ㄇㄊㄧㄧㄗㄅ
你是全能神=ㄋㄕㄑㄋㄕ
心疼自己=ㄒㄊㄗㄐ
掉了=ㄉㄌ
得釋放=ㄉㄕㄈ
譚詠麟,五月天=ㄊㄩㄌ,ㄨㄩㄊ
劉若英,周迅,桂綸鎂,湯唯=ㄌㄖㄧ,ㄓㄒ,ㄍㄌㄇ,ㄊㄨ
封茗囧菌=ㄈㄇㄐㄐ
呼斯楞=ㄏㄙㄌ
讓我留在你身邊=ㄖㄨㄌㄗㄋㄕㄅ
愷樂=ㄎㄌ
男兒的心聲(純伴奏)=ㄋㄦㄉㄒㄕ(ㄔㄅㄗ)
蘭亭序(純伴奏)=ㄌㄊㄒ(ㄔㄅㄗ)
秋天=ㄑㄊ
毛不易,周深=ㄇㄅㄧ,ㄓㄕ
醉相思=ㄗㄒㄙ
小公主=ㄒㄍㄓ
大逃殺=ㄉㄊㄕ
流浪到台北=ㄌㄌㄉㄊㄅ
以利亞的日子=ㄧㄌㄧㄉㄖㄗ
思念誰=ㄙㄋㄕ
手牽手=ㄕㄑㄕ
指望=ㄓㄨ
軟弱的我變剛強=ㄖㄖㄉㄨㄅㄍㄑ
望露的春花=ㄨㄌㄉㄔㄏ
上帝能夠=ㄕㄉㄋㄍ
一串心=ㄧㄔㄒ
風吹的願望=ㄈㄔㄉㄩㄨ
忘了怎麼愛你=ㄨㄌㄗㄇㄞㄋ
高勝美=ㄍㄕㄇ
熊仔,吳卓源,=ㄒㄗ,ㄨㄓㄩ,
黏黏=ㄋㄋ
針線情=ㄓㄒㄑ
說=ㄕ
葛仲珊,安心亞=ㄍㄓㄕ,ㄢㄒㄧ
晚安台灣=ㄨㄢㄊㄨ
望月想愛人(純伴奏)=ㄨㄩㄒㄞㄖ(ㄔㄅㄗ)
多情蝴蝶(純伴奏)=ㄉㄑㄏㄉ(ㄔㄅㄗ)
反方向的鐘=ㄈㄈㄒㄉㄓ
基因決定我愛你=ㄐㄧㄐㄉㄨㄞㄋ
踏破鐵鞋(純伴奏)=ㄊㄆㄊㄒ(ㄔㄅㄗ)
千萬個理由=ㄑㄨㄍㄌㄧ
犀利=ㄒㄌ
張北北=ㄓㄅㄅ
小蘋果(純伴奏)=ㄒㄆㄍ(ㄔㄅㄗ)
勇=ㄩ
紅薔薇白玫瑰=ㄏㄑㄨㄅㄇㄍ
路長情更長=ㄌㄔㄑㄍㄔ
命運=ㄇㄩ
捲菸(純伴奏)=ㄐㄧ(ㄔㄅㄗ)
疼你若生命(純伴奏)=ㄊㄋㄖㄕㄇ(ㄔㄅㄗ)
菩薩蠻=ㄆㄙㄇ
最好的事=ㄗㄏㄉㄕ
記得(純伴奏)=ㄐㄉ(ㄔㄅㄗ)
主啊我們也要=ㄓㄚㄨㄇㄧㄧ
是我不夠好=ㄕㄨㄅㄍㄏ
港邊戀情=ㄍㄅㄌㄑ
成功的條件(純伴奏)=ㄔㄍㄉㄊㄐ(ㄔㄅㄗ)
溫柔#=ㄨㄖ#
如果你還在就好了=ㄖㄍㄋㄏㄗㄐㄏㄌ
永不失聯的愛(純伴奏)=ㄩㄅㄕㄌㄉㄞ(ㄔㄅㄗ)
放輕點=ㄈㄑㄉ
華晨宇,楊宗緯=ㄏㄔㄩ,ㄧㄗㄨ
周華健=ㄓㄏㄐ
小時候=ㄒㄕㄏ
隔離=ㄍㄌ
一口氣=ㄧㄎㄑ
劉芷融=ㄌㄓㄖ
愛的路上我和你(純伴奏)=ㄞㄉㄌㄕㄨㄏㄋ(ㄔㄅㄗ)
懸日=ㄒㄖ
想講你知=ㄒㄐㄋㄓ
喜歡=ㄒㄏ
不讓我的眼淚陪我過夜(純伴奏)=ㄅㄖㄨㄉㄧㄌㄆㄨㄍㄧ(ㄔㄅㄗ)
小虎隊=ㄒㄏㄉ
我是你的=ㄨㄕㄋㄉ
腳踏車=ㄐㄊㄔ
寂寞的眼=ㄐㄇㄉㄧ
張秀卿,鄔兆邦=ㄓㄒㄑ,ㄨㄓㄅ
傻笑=ㄕㄒ
女性的哀怨=ㄋㄒㄉㄞㄩ
圈,不才=ㄑ,ㄅㄘ
楊丞琳=ㄧㄔㄌ
李翊君,江宏恩=ㄌㄧㄐ,ㄐㄏㄣ
黑吃黑=ㄏㄔㄏ
飛在風中的小雨=ㄈㄗㄈㄓㄉㄒㄩ
但是又何奈=ㄉㄕㄧㄏㄋ
情非得已=ㄑㄈㄉㄧ
張惠妹蕭敬騰=ㄓㄏㄇㄒㄐㄊ
涼涼(純伴奏)=ㄌㄌ(ㄔㄅㄗ)
愛如空氣=ㄞㄖㄎㄑ
多遠都要在一起=ㄉㄩㄉㄧㄗㄧㄑ
朋友只有你=ㄆㄧㄓㄧㄋ
說散就散=ㄕㄙㄐㄙ
十三號星期舞=ㄕㄙㄏㄒㄑㄨ
港都好男兒=ㄍㄉㄏㄋㄦ
林宗興=ㄌㄗㄒ
一個光年的距離=ㄧㄍㄍㄋㄉㄐㄌ
你=ㄋ
十字路口=ㄕㄗㄌㄎ
七老八十=ㄑㄌㄅㄕ
信,=ㄒ,
情變卦=ㄑㄅㄍ
墜落=ㄓㄌ
誓言=ㄕㄧ
消極掰=ㄒㄐㄅ
魏妙如=ㄨㄇㄖ
張靚穎=ㄓㄐㄧ
你少在那邊=ㄋㄕㄗㄋㄅ
亡命之徒=ㄨㄇㄓㄊ
台灣爽=ㄊㄨㄕ
心事誰人知(純伴奏)=ㄒㄕㄕㄖㄓ(ㄔㄅㄗ)
一萬個捨不得(純伴奏)=ㄧㄨㄍㄕㄅㄉ(ㄔㄅㄗ)
全部都給你=ㄑㄅㄉㄍㄋ
大開眼戒=ㄉㄎㄧㄐ
天生自然=ㄊㄕㄗㄖ
苦澀黑咖啡=ㄎㄙㄏㄎㄈ
摩天輪的思念(純伴奏)=ㄇㄊㄌㄉㄙㄋ(ㄔㄅㄗ)
台灣加油=ㄊㄨㄐㄧ
不應該勇敢=ㄅㄧㄍㄩㄍ
音闕詩聽,李佳思=ㄧㄑㄕㄊ,ㄌㄐㄙ
側臉=ㄘㄌ
兒歌=ㄦㄍ
信樂團=ㄒㄩㄊ
感情線=ㄍㄑㄒ
在我生命中的每一天=ㄗㄨㄕㄇㄓㄉㄇㄧㄊ
不再讓你孤單=ㄅㄗㄖㄋㄍㄉ
刺蝟=ㄘㄨ
徐若瑄=ㄒㄖㄒ
田麗=ㄊㄌ
壞女孩=ㄏㄋㄏ
婚禮的祝福=ㄏㄌㄉㄓㄈ
浮雲遊子=ㄈㄩㄧㄗ
五月天,李榮浩,蕭敬騰,毛不易=ㄨㄩㄊ,ㄌㄖㄏ,ㄒㄐㄊ,ㄇㄅㄧ
決心(純伴奏)=ㄐㄒ(ㄔㄅㄗ)
歸去來兮(純伴奏)=ㄍㄑㄌㄒ(ㄔㄅㄗ)
傻呆呆=ㄕㄞㄞ
心痛的情歌=ㄒㄊㄉㄑㄍ
解憂=ㄐㄧ
夢中的人=ㄇㄓㄉㄖ
心追風=ㄒㄓㄈ
我有喜樂=ㄨㄧㄒㄌ
心似煙火=ㄒㄙㄧㄏ
分開以後=ㄈㄎㄧㄏ
夜曲(純伴奏)=ㄧㄑ(ㄔㄅㄗ)
失眠飛行=ㄕㄇㄈㄒ
最甜情歌(純伴奏)=ㄗㄊㄑㄍ(ㄔㄅㄗ)
配得頌揚=ㄆㄉㄙㄧ
好膽你就來(純伴奏)=ㄏㄉㄋㄐㄌ(ㄔㄅㄗ)
虎姑婆=ㄏㄍㄆ
平野綾=ㄆㄧㄌ
少女=ㄕㄋ
陳淑樺,成龍=ㄔㄕㄏ,ㄔㄌ
敢傻就是我的本事=ㄍㄕㄐㄕㄨㄉㄅㄕ
累了走了散了=ㄌㄌㄗㄌㄙㄌ
大大的擁抱=ㄉㄉㄉㄩㄅ
洪百慧林俊吉=ㄏㄅㄏㄌㄐㄐ
筷子=ㄎㄗ
幸福難不難=ㄒㄈㄋㄅㄋ
柵欄間隙偷窺你=ㄓㄌㄐㄒㄊㄎㄋ
獲得=ㄏㄉ
不再是我乃是基督=ㄅㄗㄕㄨㄋㄕㄐㄉ
霍建華趙麗穎=ㄏㄐㄏㄓㄌㄧ
今宵多珍重=ㄐㄒㄉㄓㄓ
怎麼=ㄗㄇ
自由發揮=ㄗㄧㄈㄏ
春天的吶喊=ㄔㄊㄉㄋㄏ
劉子千=ㄌㄗㄑ
暫時失控=ㄓㄕㄕㄎ
愛一半=ㄞㄧㄅ
一下下=ㄧㄒㄒ
功夫=ㄍㄈ
反骨男孩=ㄈㄍㄋㄏ
愛情的故事=ㄞㄑㄉㄍㄕ
最終話=ㄗㄓㄏ
桃花旗袍(純伴奏)=ㄊㄏㄑㄆ(ㄔㄅㄗ)
張蓉蓉=ㄓㄖㄖ
單身情歌=ㄉㄕㄑㄍ
赤血長殷(純伴奏)=ㄔㄒㄔㄧ(ㄔㄅㄗ)
太陽(純伴奏)=ㄊㄧ(ㄔㄅㄗ)
朋友別哭=ㄆㄧㄅㄎ
她來聽我的演唱會(純伴奏)=ㄊㄌㄊㄨㄉㄧㄔㄏ(ㄔㄅㄗ)
不在乎=ㄅㄗㄏ
我愛的人=ㄨㄞㄉㄖ
讓回憶隨風飄=ㄖㄏㄧㄙㄈㄆ
如果可以(純伴奏)=ㄖㄍㄎㄧ(ㄔㄅㄗ)
心急人上=ㄒㄐㄖㄕ
本來=ㄅㄌ
伊斯坦堡=ㄧㄙㄊㄅ
離別(純伴奏)=ㄌㄅ(ㄔㄅㄗ)
無人車站=ㄨㄖㄔㄓ
關山酒=ㄍㄕㄐ
可憐彼個小姑娘=ㄎㄌㄅㄍㄒㄍㄋ
嘻哈沒有派對=ㄒㄏㄇㄧㄆㄉ
風中飄=ㄈㄓㄆ
阿美!阿美!=ㄚㄇ!ㄚㄇ!
後來後來=ㄏㄌㄏㄌ
當每顆星星=ㄉㄇㄎㄒㄒ
反背(純伴奏)=ㄈㄅ(ㄔㄅㄗ)
明月心=ㄇㄩㄒ
關於我愛你=ㄍㄩㄨㄞㄋ
一支番仔火=ㄧㄓㄈㄗㄏ
櫻花姊妹=ㄧㄏㄗㄇ
于文文=ㄩㄨㄨ
顯微鏡下的愛情=ㄒㄨㄐㄒㄉㄞㄑ
張宇=ㄓㄩ
楊坤蕭薔=ㄧㄎㄒㄑ
香水有毒=ㄒㄕㄧㄉ
今晚你想念的人是不是我=ㄐㄨㄋㄒㄋㄉㄖㄕㄅㄕㄨ
你的名字我的姓氏=ㄋㄉㄇㄗㄨㄉㄒㄕ
遙遠的她(純伴奏)=ㄧㄩㄉㄊ(ㄔㄅㄗ)
帶菌者=ㄉㄐㄓ
失戀慶功宴=ㄕㄌㄑㄍㄧ
你有沒有深愛過=ㄋㄧㄇㄧㄕㄞㄍ
丁噹=ㄉㄉ
張艾嘉=ㄓㄞㄐ
天使的偏執=ㄊㄕㄉㄆㄓ
孤兒淚=ㄍㄦㄌ
學不會=ㄒㄅㄏ
北極之光=ㄅㄐㄓㄍ
寂寞之光=ㄐㄇㄓㄍ
撐腰=ㄔㄧ
老婆(純伴奏)=ㄌㄆ(ㄔㄅㄗ)
逃亡=ㄊㄨ
失約(純伴奏)=ㄕㄩ(ㄔㄅㄗ)
不染=ㄅㄖ
我不是你想像那麼勇敢=ㄨㄅㄕㄋㄒㄒㄋㄇㄩㄍ
楊宗緯,張碧晨=ㄧㄗㄨ,ㄓㄅㄔ
風中燈=ㄈㄓㄉ
紅塵有你=ㄏㄔㄧㄋ
癡情月娘島=ㄔㄑㄩㄋㄉ
心跳(純伴奏)=ㄒㄊ(ㄔㄅㄗ)
皆可=ㄐㄎ
屁孩,黃明志=ㄆㄏ,ㄏㄇㄓ
情深深雨濛濛=ㄑㄕㄕㄩㄇㄇ
慶祝=ㄑㄓ
青春花=ㄑㄔㄏ
葉歡=ㄧㄏ
南瓜妮歌迷俱樂部=ㄋㄍㄋㄍㄇㄐㄌㄅ
全新的你=ㄑㄒㄉㄋ
永遠不分離=ㄩㄩㄅㄈㄌ
傷心的溫柔=ㄕㄒㄉㄨㄖ
只是太愛你(純伴奏)=ㄓㄕㄊㄞㄋ(ㄔㄅㄗ)
再會啦心愛的人=ㄗㄏㄌㄒㄞㄉㄖ
無心戀唱=ㄨㄒㄌㄔ
黃鶯鶯=ㄏㄧㄧ
三代目=ㄙㄉㄇ
起風了(純伴奏)=ㄑㄈㄌ(ㄔㄅㄗ)
我愛過你(純伴奏)=ㄨㄞㄍㄋ(ㄔㄅㄗ)
你乾杯=ㄋㄍㄅ
我問天=ㄨㄨㄊ
憂歡派對,小虎隊=ㄧㄏㄆㄉ,ㄒㄏㄉ
一青窈=ㄧㄑㄧ
不染(純伴奏)=ㄅㄖ(ㄔㄅㄗ)
你記得嗎=ㄋㄐㄉㄇ
你眼中的我=ㄋㄧㄓㄉㄨ
不屑=ㄅㄒ
寶石=ㄅㄕ
沈建豪=ㄔㄐㄏ
作陣彼一暝(純伴奏)=ㄗㄓㄅㄧㄇ(ㄔㄅㄗ)
為著你的榮耀=ㄨㄓㄋㄉㄖㄧ
暖暖的小時光(純伴奏)=ㄋㄋㄉㄒㄕㄍ(ㄔㄅㄗ)
一嘴乾一杯=ㄧㄗㄍㄧㄅ
斷線情=ㄉㄒㄑ
軟土深掘=ㄖㄊㄕㄐ
溫柔的奇蹟(純伴奏)=ㄨㄖㄉㄑㄐ(ㄔㄅㄗ)
玖壹壹陳嘉樺=ㄐㄧㄧㄔㄐㄏ
陰天=ㄧㄊ
上海灘=ㄕㄏㄊ
安苡葳許志豪=ㄢㄧㄨㄒㄓㄏ
冷井情深=ㄌㄐㄑㄕ
死結=ㄙㄐ
討好=ㄊㄏ
愛了就知道=ㄞㄌㄐㄓㄉ
寂寞流星群=ㄐㄇㄌㄒㄑ
愛過你這件事(純伴奏)=ㄞㄍㄋㄓㄐㄕ(ㄔㄅㄗ)
疼你若生命=ㄊㄋㄖㄕㄇ
一個人的行李=ㄧㄍㄖㄉㄒㄌ
微笑著揮手=ㄨㄒㄓㄏㄕ
馬不停蹄的憂傷=ㄇㄅㄊㄊㄉㄧㄕ
不確定=ㄅㄑㄉ
宮崎步=ㄍㄑㄅ
我們歡迎君王降臨=ㄨㄇㄏㄧㄐㄨㄐㄌ
戀曲=ㄌㄑ
看淡=ㄎㄉ
音闕詩聽,趙方婧=ㄧㄑㄕㄊ,ㄓㄈㄐ
你快回來=ㄋㄎㄏㄌ
深情戀夢=ㄕㄑㄌㄇ
舊愛還是最美=ㄐㄞㄏㄕㄗㄇ
前前後後左左右右=ㄑㄑㄏㄏㄗㄗㄧㄧ
甘願受=ㄍㄩㄕ
我很想愛他=ㄨㄏㄒㄞㄊ
長鏡頭=ㄔㄐㄊ
一顆蘋果(純伴奏)=ㄧㄎㄆㄍ(ㄔㄅㄗ)
一萬里情路=ㄧㄨㄌㄑㄌ
林芯儀=ㄌㄒㄧ
拿走了什麼(純伴奏)=ㄋㄗㄌㄕㄇ(ㄔㄅㄗ)
那一刻心動(純伴奏)=ㄋㄧㄎㄒㄉ(ㄔㄅㄗ)
讓愛轉動整個宇宙=ㄖㄞㄓㄉㄓㄍㄩㄓ
思念是一把刀=ㄙㄋㄕㄧㄅㄉ
愛這種離譜感覺=ㄞㄓㄓㄌㄆㄍㄐ
岩男潤子=ㄧㄋㄖㄗ
不得不愛=ㄅㄉㄅㄞ
最後的/=ㄗㄏㄉ/
孟婆湯=ㄇㄆㄊ
寶貝我們不要哭=ㄅㄅㄨㄇㄅㄧㄎ
我不會唱歌=ㄨㄅㄏㄔㄍ
別把疼你的人弄丟了=ㄅㄅㄊㄋㄉㄖㄋㄉㄌ
其實你並沒那麼孤單(純伴奏)=ㄑㄕㄋㄅㄇㄋㄇㄍㄉ(ㄔㄅㄗ)
明日天涯=ㄇㄖㄊㄧ
飛雲之下=ㄈㄩㄓㄒ
問心無愧=ㄨㄒㄨㄎ
選擇失憶=ㄒㄗㄕㄧ
累格=ㄌㄍ
多美麗=ㄉㄇㄌ
客家人一條心=ㄎㄐㄖㄧㄊㄒ
城南=ㄔㄋ
思念總在分手後=ㄙㄋㄗㄗㄈㄕㄏ
大約在冬季(純伴奏)=ㄉㄩㄗㄉㄐ(ㄔㄅㄗ)
愛無赦=ㄞㄨㄕ
三心兩意(純伴奏)=ㄙㄒㄌㄧ(ㄔㄅㄗ)
搖搖頭=ㄧㄧㄊ
請不要把眼光離開=ㄑㄅㄧㄅㄧㄍㄌㄎ
當我們一起走過=ㄉㄨㄇㄧㄑㄗㄍ
王妃=ㄨㄈ
管罄=ㄍㄑ
戴梅君伍浩哲=ㄉㄇㄐㄨㄏㄓ
退後=ㄊㄏ
故鄉的月(純伴奏)=ㄍㄒㄉㄩ(ㄔㄅㄗ)
愛愛=ㄞㄞ
姚貝娜=ㄧㄅㄋ
楊小壯=ㄧㄒㄓ
櫻桃幫=ㄧㄊㄅ
一個人睡=ㄧㄍㄖㄕ
鴻雁=ㄏㄧ
郁可唯=ㄩㄎㄨ
不再說分手=ㄅㄗㄕㄈㄕ
太空漫遊=ㄊㄎㄇㄧ
乘虛而入=ㄔㄒㄦㄖ
大笨鐘=ㄉㄅㄓ
青鳥=ㄑㄋ
歲月的批=ㄙㄩㄉㄆ
滿有能力=ㄇㄧㄋㄌ
王見王=ㄨㄐㄨ
除了愛你還能愛誰=ㄔㄌㄞㄋㄏㄋㄞㄕ
憑什麼=ㄆㄕㄇ
悄悄告訴你=ㄑㄑㄍㄙㄋ
聖靈請你來充滿我心=ㄕㄌㄑㄋㄌㄔㄇㄨㄒ
江志豐=ㄐㄓㄈ
你不是我的(純伴奏)=ㄋㄅㄕㄨㄉ(ㄔㄅㄗ)
原來這才是真的你=ㄩㄌㄓㄘㄕㄓㄉㄋ
大公雞=ㄉㄍㄐ
我的天空=ㄨㄉㄊㄎ
不顧一切愛你=ㄅㄍㄧㄑㄞㄋ
在樹上唱歌=ㄗㄕㄕㄔㄍ
再會啦心愛的無緣的人(純伴奏)=ㄗㄏㄌㄒㄞㄉㄨㄩㄉㄖ(ㄔㄅㄗ)
先分開=ㄒㄈㄎ
愛的羅曼死=ㄞㄉㄌㄇㄙ
東來東往=ㄉㄌㄉㄨ
繁華夢=ㄈㄏㄇ
多謝照顧=ㄉㄒㄓㄍ
洛少爺封茗囧菌=ㄌㄕㄧㄈㄇㄐㄐ
不求人=ㄅㄑㄖ
渡=ㄉ
傷心酒店=ㄕㄒㄐㄉ
吳奇隆=ㄨㄑㄌ
年輪=ㄋㄌ
許鈞=ㄒㄐ
就在星期五=ㄐㄗㄒㄑㄨ
歲月的眼睛=ㄙㄩㄉㄧㄐ
光芒=ㄍㄇ
猜不透=ㄘㄅㄊ
靈糧堂=ㄌㄌㄊ
莎士比亞的天份=ㄕㄕㄅㄧㄉㄊㄈ
黃大煒=ㄏㄉㄨ
其實我不快樂=ㄑㄕㄨㄅㄎㄌ
晚安(純伴奏)=ㄨㄢ(ㄔㄅㄗ)
地球上最浪漫的一首歌=ㄉㄑㄕㄗㄌㄇㄉㄧㄕㄍ
愛一個人好難=ㄞㄧㄍㄖㄏㄋ
你啊你啊=ㄋㄚㄋㄚ
當時的月亮=ㄉㄕㄉㄩㄌ
絕對發言=ㄐㄉㄈㄧ
文慧如,邱鋒澤=ㄨㄏㄖ,ㄑㄈㄗ
分手旅行=ㄈㄕㄌㄒ
我是誰我是誰我是誰=ㄨㄕㄕㄨㄕㄕㄨㄕㄕ
再見只是陌生人=ㄗㄐㄓㄕㄇㄕㄖ
船螺三聲=ㄔㄌㄙㄕ
十面埋伏=ㄕㄇㄇㄈ
風！告訴我=ㄈ！ㄍㄙㄨ
鳳凰于飛=ㄈㄏㄩㄈ
進階=ㄐㄐ
戴安娜=ㄉㄢㄋ
新風暴=ㄒㄈㄅ
大黑摩季=ㄉㄏㄇㄐ
隨心所遇=ㄙㄒㄙㄩ
空笑夢=ㄎㄒㄇ
陳大天=ㄔㄉㄊ
就別愛我(純伴奏)=ㄐㄅㄞㄨ(ㄔㄅㄗ)
明日天涯(純伴奏)=ㄇㄖㄊㄧ(ㄔㄅㄗ)
驚蟄=ㄐㄓ
于台煙=ㄩㄊㄧ
陪我歌唱=ㄆㄨㄍㄔ
費翔=ㄈㄒ
囍=ㄒ
離家=ㄌㄐ
愛的過火=ㄞㄉㄍㄏ
別再撐了=ㄅㄗㄔㄌ
十二生肖=ㄕㄦㄕㄒ
光年之外譜面=ㄍㄋㄓㄨㄆㄇ
憨人=ㄏㄖ
我一個人住(純伴奏)=ㄨㄧㄍㄖㄓ(ㄔㄅㄗ)
寵兒=ㄔㄦ
張衛健=ㄓㄨㄐ
一生的朋友=ㄧㄕㄉㄆㄧ
漂流浴室(純伴奏)=ㄆㄌㄩㄕ(ㄔㄅㄗ)
傷心童話=ㄕㄒㄊㄏ
愛江山更愛美人(純伴奏)=ㄞㄐㄕㄍㄞㄇㄖ(ㄔㄅㄗ)
鄭源=ㄓㄩ
安九(純伴奏)=ㄢㄐ(ㄔㄅㄗ)
追幸福=ㄓㄒㄈ
船歌=ㄔㄍ
不要驚動愛情(純伴奏)=ㄅㄧㄐㄉㄞㄑ(ㄔㄅㄗ)
卡奇社=ㄎㄑㄕ
都怪我(純伴奏)=ㄉㄍㄨ(ㄔㄅㄗ)
你知道我在等你嗎=ㄋㄓㄉㄨㄗㄉㄋㄇ
梅艷芳,張國榮=ㄇㄧㄈ,ㄓㄍㄖ
風飛沙=ㄈㄈㄕ
明明就(純伴奏)=ㄇㄇㄐ(ㄔㄅㄗ)
蘇振華洪百慧=ㄙㄓㄏㄏㄅㄏ
張學友,陳慧嫻=ㄓㄒㄧ,ㄔㄏㄒ
不是每個戀曲都有美好回憶(純伴奏)=ㄅㄕㄇㄍㄌㄑㄉㄧㄇㄏㄏㄧ(ㄔㄅㄗ)
秋天不回來=ㄑㄊㄅㄏㄌ
翻不完的夏天=ㄈㄅㄨㄉㄒㄊ
張瀛仁=ㄓㄧㄖ
米莎=ㄇㄙ
本多=ㄅㄉ
風中的羽翼=ㄈㄓㄉㄩㄧ
不過問(純伴奏)=ㄅㄍㄨ(ㄔㄅㄗ)
施文彬厝邊隔壁兒童合唱團=ㄕㄨㄅㄘㄅㄍㄅㄦㄊㄏㄔㄊ
連晨翔=ㄌㄔㄒ
那一場風花雪月的事=ㄋㄧㄔㄈㄏㄒㄩㄉㄕ
她以為她很美麗=ㄊㄧㄨㄊㄏㄇㄌ
是日救星=ㄕㄖㄐㄒ
心碎=ㄒㄙ
我是如此相信=ㄨㄕㄖㄘㄒㄒ
手掌心(純伴奏)=ㄕㄓㄒ(ㄔㄅㄗ)
答應我=ㄉㄧㄨ
閻羅王=ㄧㄌㄨ
三人行=ㄙㄖㄒ
像我這樣的朋友=ㄒㄨㄓㄧㄉㄆㄧ
赤伶=ㄔㄌ
心願=ㄒㄩ
往昔=ㄨㄒ
星勢力=ㄒㄕㄌ
黑雨=ㄏㄩ
誰來愛我(純伴奏)=ㄕㄌㄞㄨ(ㄔㄅㄗ)
寂寞的酒=ㄐㄇㄉㄐ
最好的快要發生=ㄗㄏㄉㄎㄧㄈㄕ
下一個我=ㄒㄧㄍㄨ
沿海公路的出口=ㄧㄏㄍㄌㄉㄔㄎ
我不為明天憂慮=ㄨㄅㄨㄇㄊㄧㄌ
認定祢=ㄖㄉㄋ
來向耶和華歌唱(純伴奏)=ㄌㄒㄧㄏㄏㄍㄔ(ㄔㄅㄗ)
活著為要敬拜祢=ㄏㄓㄨㄧㄐㄅㄋ
擁抱失敗=ㄩㄅㄕㄅ
征服=ㄓㄈ
荒謬英雄=ㄏㄇㄧㄒ
為什麼我哪會愛著你=ㄨㄕㄇㄨㄋㄏㄞㄓㄋ
我不難過=ㄨㄅㄋㄍ
愛不起=ㄞㄅㄑ
愛人=ㄞㄖ
七十億分之一加一=ㄑㄕㄧㄈㄓㄧㄐㄧ
幸福氧氣=ㄒㄈㄧㄑ
呂建中=ㄌㄐㄓ
時間煮雨(純伴奏)=ㄕㄐㄓㄩ(ㄔㄅㄗ)
星球墜落(純伴奏)=ㄒㄑㄓㄌ(ㄔㄅㄗ)
再見南國=ㄗㄐㄋㄍ
田川寿美=ㄊㄔ寿ㄇ
星火=ㄒㄏ
哈酒=ㄏㄐ
嗶嗶嗶(純伴奏)=ㄅㄅㄅ(ㄔㄅㄗ)
猜猜看=ㄘㄘㄎ
瘋狂世界=ㄈㄎㄕㄐ
林良歡,翁立友=ㄌㄌㄏ,ㄨㄌㄧ
愛如潮水(純伴奏)=ㄞㄖㄔㄕ(ㄔㄅㄗ)
愛就對了=ㄞㄐㄉㄌ
時速=ㄕㄙ
我美好救主=ㄨㄇㄏㄐㄓ
刮目相看=ㄍㄇㄒㄎ
被傷過的心還可以愛誰=ㄅㄕㄍㄉㄒㄏㄎㄧㄞㄕ
也可以=ㄧㄎㄧ
鯨落(純伴奏)=ㄐㄌ(ㄔㄅㄗ)
雨天=ㄩㄊ
月娘啊月娘=ㄩㄋㄚㄩㄋ
羅吉鎮,李碧華=ㄌㄐㄓ,ㄌㄅㄏ
溫柔的外衫=ㄨㄖㄉㄨㄕ
表面的和平(純伴奏)=ㄅㄇㄉㄏㄆ(ㄔㄅㄗ)
康定情歌=ㄎㄉㄑㄍ
水星記=ㄕㄒㄐ
我記得我愛過=ㄨㄐㄉㄨㄞㄍ
林姍,翁立友=ㄌㄒ,ㄨㄌㄧ
玫瑰紅=ㄇㄍㄏ
一暝三冬=ㄧㄇㄙㄉ
雲河=ㄩㄏ
再見煙火=ㄗㄐㄧㄏ
好愛她好想他=ㄏㄞㄊㄏㄒㄊ
鏡花水月=ㄐㄏㄕㄩ
淡水舊情=ㄉㄕㄐㄑ
無你惦身邊(純伴奏)=ㄨㄋㄉㄕㄅ(ㄔㄅㄗ)
因為愛所以愛(純伴奏)=ㄧㄨㄞㄙㄧㄞ(ㄔㄅㄗ)
主我獻上生命給祢=ㄓㄨㄒㄕㄕㄇㄍㄋ
Ø=Ø
沒有如果(純伴奏)=ㄇㄧㄖㄍ(ㄔㄅㄗ)
敢愛敢當=ㄍㄞㄍㄉ
愛情教會我們的事=ㄞㄑㄐㄏㄨㄇㄉㄕ
你如何失戀=ㄋㄖㄏㄕㄌ
我不知道愛是什麼(純伴奏)=ㄨㄅㄓㄉㄞㄕㄕㄇ(ㄔㄅㄗ)
愛情免簽字=ㄞㄑㄇㄑㄗ
水汪汪=ㄕㄨㄨ
愛的力量=ㄞㄉㄌㄌ
吳申梅=ㄨㄕㄇ
今生最愛的人(純伴奏)=ㄐㄕㄗㄞㄉㄖ(ㄔㄅㄗ)
奉獻=ㄈㄒ
讓神兒子的愛圍繞你=ㄖㄕㄦㄗㄉㄞㄨㄖㄋ
你甘會知影=ㄋㄍㄏㄓㄧ
十一年(純伴奏)=ㄕㄧㄋ(ㄔㄅㄗ)
有些事現在不做一輩子都不會做了=ㄧㄒㄕㄒㄗㄅㄗㄧㄅㄗㄉㄅㄏㄗㄌ
繼續向前行=ㄐㄒㄒㄑㄒ
尚愛的人傷我尚重=ㄕㄞㄉㄖㄕㄨㄕㄔ
大舌頭=ㄉㄕㄊ
音樂=ㄧㄩ
男兒情淚=ㄋㄦㄑㄌ
她在睡前哭泣=ㄊㄗㄕㄑㄎㄑ
孫子涵=ㄙㄗㄏ
男人有淚=ㄋㄖㄧㄌ
陳珊妮,魏如萱=ㄔㄕㄋ,ㄨㄖㄒ
如果=ㄖㄍ
辛龍=ㄒㄌ
快樂的甘蔗人(純伴奏)=ㄎㄌㄉㄍㄓㄖ(ㄔㄅㄗ)
暗了,亮了=ㄢㄌ,ㄌㄌ
讓每天都是聖誕節=ㄖㄇㄊㄉㄕㄕㄉㄐ
眉飛色舞=ㄇㄈㄙㄨ
我怎麼這麼好看=ㄨㄗㄇㄓㄇㄏㄎ
周杰倫,袁詠琳=ㄓㄐㄌ,ㄩㄩㄌ
三寸天堂(純伴奏)=ㄙㄘㄊㄊ(ㄔㄅㄗ)
你的姑娘(純伴奏)=ㄋㄉㄍㄋ(ㄔㄅㄗ)
部落格冬天=ㄅㄌㄍㄉㄊ
冷暴力(純伴奏)=ㄌㄅㄌ(ㄔㄅㄗ)
淋雨一直走=ㄌㄩㄧㄓㄗ
情人的眼淚=ㄑㄖㄉㄧㄌ
我愛你勝過你愛我(純伴奏)=ㄨㄞㄋㄕㄍㄋㄞㄨ(ㄔㄅㄗ)
有沒有一首歌會讓你想起我=ㄧㄇㄧㄧㄕㄍㄏㄖㄋㄒㄑㄨ
關喆=ㄍㄓ
天堂有多遠=ㄊㄊㄧㄉㄩ
用盡一生的愛=ㄩㄐㄧㄕㄉㄞ
楊耀東=ㄧㄧㄉ
明日又天涯(純伴奏)=ㄇㄖㄧㄊㄧ(ㄔㄅㄗ)
叫你一聲=ㄐㄋㄧㄕ
十萬毫升淚水精密=ㄕㄨㄏㄕㄌㄕㄐㄇ
無常=ㄨㄔ
遺忘=ㄧㄨ
夏宇童=ㄒㄩㄊ
美秀集團=ㄇㄒㄐㄊ
陳予新=ㄔㄩㄒ
愛你無采工=ㄞㄋㄨㄘㄍ
魏如昀=ㄨㄖㄩ
一生一火花=ㄧㄕㄧㄏㄏ
失憶=ㄕㄧ
海誓山盟=ㄏㄕㄕㄇ
蝶々結び=ㄉ々ㄐび
感應=ㄍㄧ
更深經歷祢=ㄍㄕㄐㄌㄋ
十九歲的最後一天=ㄕㄐㄙㄉㄗㄏㄧㄊ
陳中,邱芸子=ㄔㄓ,ㄑㄩㄗ
我的一顆心(純伴奏)=ㄨㄉㄧㄎㄒ(ㄔㄅㄗ)
天下大同=ㄊㄒㄉㄊ
愛是三分迷七分痴=ㄞㄕㄙㄈㄇㄑㄈㄔ
忘了哭(純伴奏)=ㄨㄌㄎ(ㄔㄅㄗ)
又是細雨=ㄧㄕㄒㄩ
車票=ㄔㄆ
洛天依=ㄌㄊㄧ
風中的蠟燭=ㄈㄓㄉㄌㄓ
會不會你也想念我=ㄏㄅㄏㄋㄧㄒㄋㄨ
大嘴巴=ㄉㄗㄅ
未完不待續=ㄨㄨㄅㄉㄒ
我神真偉大=ㄨㄕㄓㄨㄉ
愛我的每個人=ㄞㄨㄉㄇㄍㄖ
滾滾紅塵=ㄍㄍㄏㄔ
聽海=ㄊㄏ
想死卻又不敢=ㄒㄙㄑㄧㄅㄍ
笨小孩(純伴奏)=ㄅㄒㄏ(ㄔㄅㄗ)
港邊乾杯(純伴奏)=ㄍㄅㄍㄅ(ㄔㄅㄗ)
愛,存在(純伴奏)=ㄞ,ㄘㄗ(ㄔㄅㄗ)
請先說你好(純伴奏)=ㄑㄒㄕㄋㄏ(ㄔㄅㄗ)
快樂鳥日子=ㄎㄌㄋㄖㄗ
太空=ㄊㄎ
黃安=ㄏㄢ
搖勒搖勒=ㄧㄌㄧㄌ
床頭夢=ㄔㄊㄇ
歡樂谷=ㄏㄌㄍ
其實你不懂我的心=ㄑㄕㄋㄅㄉㄨㄉㄒ
分心=ㄈㄒ
陀飛輪=ㄊㄈㄌ
恭喜恭喜=ㄍㄒㄍㄒ
風流做田人(純伴奏)=ㄈㄌㄗㄊㄖ(ㄔㄅㄗ)
今年的櫻花忘了開=ㄐㄋㄉㄧㄏㄨㄌㄎ
為你放袂落=ㄨㄋㄈㄇㄌ
黃明志,蕭敬騰=ㄏㄇㄓ,ㄒㄐㄊ
偽裝=ㄨㄓ
南山南=ㄋㄕㄋ
真相=ㄓㄒ
最美情侶=ㄗㄇㄑㄌ
林俊吉洪百慧=ㄌㄐㄐㄏㄅㄏ
微加幸福=ㄨㄐㄒㄈ
新的心跳=ㄒㄉㄒㄊ
那曾經=ㄋㄘㄐ
狂野之城(純伴奏)=ㄎㄧㄓㄔ(ㄔㄅㄗ)
沒離開過=ㄇㄌㄎㄍ
神度=ㄕㄉ
立冬(純伴奏)=ㄌㄉ(ㄔㄅㄗ)
黃仲崑=ㄏㄓㄎ
閻奕格,高爾宣=ㄧㄧㄍ,ㄍㄦㄒ
驕傲=ㄐㄠ
舊情也綿綿=ㄐㄑㄧㄇㄇ
四個朋友=ㄙㄍㄆㄧ
下個雨季=ㄒㄍㄩㄐ
關詩敏=ㄍㄕㄇ
男朋友(純伴奏)=ㄋㄆㄧ(ㄔㄅㄗ)
老伴=ㄌㄅ
快樂眼淚=ㄎㄌㄧㄌ
妳是我的生命=ㄋㄕㄨㄉㄕㄇ
周興哲=ㄓㄒㄓ
愛你(純伴奏)=ㄞㄋ(ㄔㄅㄗ)
交換餘生(純伴奏)=ㄐㄏㄩㄕ(ㄔㄅㄗ)
每次都想呼喊妳的名字(純伴奏)=ㄇㄘㄉㄒㄏㄏㄋㄉㄇㄗ(ㄔㄅㄗ)
漂洋過海=ㄆㄧㄍㄏ
幸福的代誌=ㄒㄈㄉㄉㄓ
花粥,王勝男=ㄏㄓ,ㄨㄕㄋ
三生石=ㄙㄕㄕ
招弟=ㄓㄉ
原來我也可以幸福=ㄩㄌㄨㄧㄎㄧㄒㄈ
陳淑樺=ㄔㄕㄏ
,=,
黛玉笑了=ㄉㄩㄒㄌ
歌聲滿行囊=ㄍㄕㄇㄒㄋ
愛･無卡紙=ㄞ･ㄨㄎㄓ
妮妮=ㄋㄋ
飄洋過海來看你(純伴奏)=ㄆㄧㄍㄏㄌㄎㄋ(ㄔㄅㄗ)
丑角=ㄔㄐ
阿拉斯加海灣(純伴奏)=ㄚㄌㄙㄐㄏㄨ(ㄔㄅㄗ)
一顆蘋果=ㄧㄎㄆㄍ
姚莉,楊光=ㄧㄌ,ㄧㄍ
冬眠=ㄉㄇ
新店行道會=ㄒㄉㄒㄉㄏ
星和遠方(純伴奏)=ㄒㄏㄩㄈ(ㄔㄅㄗ)
美好生活=ㄇㄏㄕㄏ
滿天星=ㄇㄊㄒ
我走後=ㄨㄗㄏ
亦帆邰正宵=ㄧㄈㄊㄓㄒ
多情城市=ㄉㄑㄔㄕ
談情看愛=ㄊㄑㄎㄞ
遠距離的愛(純伴奏)=ㄩㄐㄌㄉㄞ(ㄔㄅㄗ)
聽說北京下雪了=ㄊㄕㄅㄐㄒㄒㄌ
聖誕節=ㄕㄉㄐ
知否知否=ㄓㄈㄓㄈ
冷月照孤單=ㄌㄩㄓㄍㄉ
黑色幽默=ㄏㄙㄧㄇ
梅蘭梅蘭我愛你(純伴奏)=ㄇㄌㄇㄌㄨㄞㄋ(ㄔㄅㄗ)
兩個太陽=ㄌㄍㄊㄧ
陽帆=ㄧㄈ
喬幼,莊振凱=ㄑㄧ,ㄓㄓㄎ
客家本色=ㄎㄐㄅㄙ
心愛的再會啦=ㄒㄞㄉㄗㄏㄌ
聖所=ㄕㄙ
男兒當自強=ㄋㄦㄉㄗㄑ
寂寞公路=ㄐㄇㄍㄌ
春風吻上我的臉(純伴奏)=ㄔㄈㄨㄕㄨㄉㄌ(ㄔㄅㄗ)
牽掛=ㄑㄍ
這樣你還要愛我嗎=ㄓㄧㄋㄏㄧㄞㄨㄇ
台北的天空=ㄊㄅㄉㄊㄎ
五月天,蔡依林=ㄨㄩㄊ,ㄘㄧㄌ
對摺=ㄉㄓ
,江澈,=,ㄐㄔ,
不顧一切=ㄅㄍㄧㄑ
愛投羅網=ㄞㄊㄌㄨ
高爾宣陳忻玥=ㄍㄦㄒㄔㄒㄩ
紅螞蟻=ㄏㄇㄧ
愛情密碼(純伴奏)=ㄞㄑㄇㄇ(ㄔㄅㄗ)
林俊傑,林俊峰=ㄌㄐㄐ,ㄌㄐㄈ
可是我還是學不會=ㄎㄕㄨㄏㄕㄒㄅㄏ
三年的舊情=ㄙㄋㄉㄐㄑ
應該=ㄧㄍ
我遇見你=ㄨㄩㄐㄋ
飛兒樂團=ㄈㄦㄩㄊ
手語=ㄕㄩ
真夏的櫻花=ㄓㄒㄉㄧㄏ
遇見=ㄩㄐ
王默君=ㄨㄇㄐ
思鄉的出外人=ㄙㄒㄉㄔㄨㄖ
許巍=ㄒㄨ
我心唯一愛慕=ㄨㄒㄨㄧㄞㄇ
葉諾帆鳳娘=ㄧㄋㄈㄈㄋ
艾怡良=ㄞㄧㄌ
天知地知=ㄊㄓㄉㄓ
我們還會相遇=ㄨㄇㄏㄏㄒㄩ
心酸的情歌=ㄒㄙㄉㄑㄍ
多美麗(純伴奏)=ㄉㄇㄌ(ㄔㄅㄗ)
一千年以後=ㄧㄑㄋㄧㄏ
反對眼淚=ㄈㄉㄧㄌ
忘記背叛=ㄨㄐㄅㄆ
千本桜=ㄑㄅ桜
只為你一人=ㄓㄨㄋㄧㄖ
無字天書=ㄨㄗㄊㄕ
路太彎=ㄌㄊㄨ
光良,曹格=ㄍㄌ,ㄘㄍ
誘惑=ㄧㄏ
匿名的寶貝=ㄋㄇㄉㄅㄅ
侯湘婷=ㄏㄒㄊ
歸來=ㄍㄌ
黃明志,王光芳=ㄏㄇㄓ,ㄨㄍㄈ
你冷得像風=ㄋㄌㄉㄒㄈ
明白=ㄇㄅ
單戀曲=ㄉㄌㄑ
玫瑰花瓣的信箋=ㄇㄍㄏㄅㄉㄒㄐ
岷江夜曲=ㄇㄐㄧㄑ
味道=ㄨㄉ
我深深渴慕=ㄨㄕㄕㄎㄇ
寬容=ㄎㄖ
雨下的瞬間=ㄩㄒㄉㄕㄐ
忘不掉的傷=ㄨㄅㄉㄉㄕ
贖罪=ㄕㄗ
我又初戀了=ㄨㄧㄔㄌㄌ
太空人=ㄊㄎㄖ
紅色高跟鞋(純伴奏)=ㄏㄙㄍㄍㄒ(ㄔㄅㄗ)
莊振凱,李明洋=ㄓㄓㄎ,ㄌㄇㄧ
潘瑋柏,黃旭,肖恩恩=ㄆㄨㄅ,ㄏㄒ,ㄒㄣㄣ
偶像練習生=ㄡㄒㄌㄒㄕ
不變的愛=ㄅㄅㄉㄞ
得意的笑=ㄉㄧㄉㄒ
落雨聲(純伴奏)=ㄌㄩㄕ(ㄔㄅㄗ)
今天之後=ㄐㄊㄓㄏ
菲尼克斯=ㄈㄋㄎㄙ
陳立農=ㄔㄌㄋ
孤獨的總和=ㄍㄉㄉㄗㄏ
暖場男朋友=ㄋㄔㄋㄆㄧ
好的晚安(純伴奏)=ㄏㄉㄨㄢ(ㄔㄅㄗ)
起床歌=ㄑㄔㄍ
夜曲=ㄧㄑ
湯潮=ㄊㄔ
盧子杰,屁孩,柯政宏=ㄌㄗㄐ,ㄆㄏ,ㄎㄓㄏ
驛動的心=ㄧㄉㄉㄒ
微笑的力量(純伴奏)=ㄨㄒㄉㄌㄌ(ㄔㄅㄗ)
彼時=ㄅㄕ
親愛的=ㄑㄞㄉ
愛笑的眼睛(純伴奏)=ㄞㄒㄉㄧㄐ(ㄔㄅㄗ)
神啊救救我=ㄕㄚㄐㄐㄨ
漂泊的人生=ㄆㄅㄉㄖㄕ
十年=ㄕㄋ
對的時間點=ㄉㄉㄕㄐㄉ
鄧妙華=ㄉㄇㄏ
我這個人=ㄨㄓㄍㄖ
最珍貴的角落=ㄗㄓㄍㄉㄐㄌ
失戀陣線聯盟=ㄕㄌㄓㄒㄌㄇ
一下下(純伴奏)=ㄧㄒㄒ(ㄔㄅㄗ)
對你愛不完(純伴奏)=ㄉㄋㄞㄅㄨ(ㄔㄅㄗ)
重出江湖=ㄔㄔㄐㄏ
將愛=ㄐㄞ
虛情假意=ㄒㄑㄐㄧ
三年=ㄙㄋ
那些我再也不做的事=ㄋㄒㄨㄗㄧㄅㄗㄉㄕ
停留=ㄊㄌ
我喜歡不我愛=ㄨㄒㄏㄅㄨㄞ
潛台詞=ㄑㄊㄘ
孤獨=ㄍㄉ
就是要=ㄐㄕㄧ
終於等到你=ㄓㄩㄉㄉㄋ
我當你空氣=ㄨㄉㄋㄎㄑ
不知所謂=ㄅㄓㄙㄨ
空想夜車=ㄎㄒㄧㄔ
此刻你聽好了(純伴奏)=ㄘㄎㄋㄊㄏㄌ(ㄔㄅㄗ)
施碧梧邰肇玫=ㄕㄅㄨㄊㄓㄇ
溫暖的山雪=ㄨㄋㄉㄕㄒ
發光的簡訊=ㄈㄍㄉㄐㄒ
蒲公英的約定=ㄆㄍㄧㄉㄩㄉ
孫楠=ㄙㄋ
周蕙=ㄓㄏ
現在你是怎樣的人?=ㄒㄗㄋㄕㄗㄧㄉㄖ?
完美主義=ㄨㄇㄓㄧ
紐約的司機駕著北京的夢(純伴奏)=ㄋㄩㄉㄙㄐㄐㄓㄅㄐㄉㄇ(ㄔㄅㄗ)
圓夢=ㄩㄇ
不如跳舞=ㄅㄖㄊㄨ
黃鴻升=ㄏㄏㄕ
啟程(純伴奏)=ㄑㄔ(ㄔㄅㄗ)
使我得生命=ㄕㄨㄉㄕㄇ
喜歡我吧=ㄒㄏㄨㄅ
怎麼捨得你=ㄗㄇㄕㄉㄋ
蕭全,孫語賽=ㄒㄑ,ㄙㄩㄙ
不值得(純伴奏)=ㄅㄓㄉ(ㄔㄅㄗ)
陳零九,邱鋒澤=ㄔㄌㄐ,ㄑㄈㄗ
江映蓉=ㄐㄧㄖ
那片海=ㄋㄆㄏ
星和遠方=ㄒㄏㄩㄈ
賊=ㄗ
遲早=ㄔㄗ
別人的(純伴奏)=ㄅㄖㄉ(ㄔㄅㄗ)
林俊傑,金莎=ㄌㄐㄐ,ㄐㄙ
扶搖=ㄈㄧ
啟程=ㄑㄔ
買買買=ㄇㄇㄇ
花茶=ㄏㄔ
像魚(純伴奏)=ㄒㄩ(ㄔㄅㄗ)
袁小迪=ㄩㄒㄉ
等無你的愛=ㄉㄨㄋㄉㄞ
可愛的馬=ㄎㄞㄉㄇ
林瓊瓏=ㄌㄑㄌ
安娣=ㄢㄉ
藍天=ㄌㄊ
柳子駿=ㄌㄗㄐ
反而=ㄈㄦ
明月千里寄相思(純伴奏)=ㄇㄩㄑㄌㄐㄒㄙ(ㄔㄅㄗ)
虛情假意(純伴奏)=ㄒㄑㄐㄧ(ㄔㄅㄗ)
我們不一樣=ㄨㄇㄅㄧㄧ
自由自在=ㄗㄧㄗㄗ
任素汐=ㄖㄙㄒ
遺憾=ㄧㄏ
一張批(純伴奏)=ㄧㄓㄆ(ㄔㄅㄗ)
可不可以愛我=ㄎㄅㄎㄧㄞㄨ
許冠傑=ㄒㄍㄐ
凡人=ㄈㄖ
眼光=ㄧㄍ
血腥愛情故事=ㄒㄒㄞㄑㄍㄕ
相依為命=ㄒㄧㄨㄇ
梁靜茹,曹格=ㄌㄐㄖ,ㄘㄍ
高橋優=ㄍㄑㄧ
原來你都在=ㄩㄌㄋㄉㄗ
唱乎爽=ㄔㄏㄕ
恨不相逢未嫁時=ㄏㄅㄒㄈㄨㄐㄕ
田庄兄哥(純伴奏)=ㄊㄓㄒㄍ(ㄔㄅㄗ)
痛也不說出口的我(純伴奏)=ㄊㄧㄅㄕㄔㄎㄉㄨ(ㄔㄅㄗ)
父子情深=ㄈㄗㄑㄕ
走慢一點點=ㄗㄇㄧㄉㄉ
掌心(純伴奏)=ㄓㄒ(ㄔㄅㄗ)
莉莉安=ㄌㄌㄢ
沒有你陪伴真的好孤單=ㄇㄧㄋㄆㄅㄓㄉㄏㄍㄉ
新年喜洋洋=ㄒㄋㄒㄧㄧ
控制狂=ㄎㄓㄎ
熊麻吉=ㄒㄇㄐ
心領神會=ㄒㄌㄕㄏ
太陽星辰=ㄊㄧㄒㄔ
今晚我要唱歌=ㄐㄨㄨㄧㄔㄍ
看得最遠的地方=ㄎㄉㄗㄩㄉㄉㄈ
黑旋風=ㄏㄒㄈ
深情相擁=ㄕㄑㄒㄩ
最後的光景=ㄗㄏㄉㄍㄐ
故鄉的門口埕=ㄍㄒㄉㄇㄎㄔ
五天幾年=ㄨㄊㄐㄋ
漂浪=ㄆㄌ
黃大城=ㄏㄉㄔ
誰來愛我=ㄕㄌㄞㄨ
等你看望你疼(純伴奏)=ㄉㄋㄎㄨㄋㄊ(ㄔㄅㄗ)
愛情的模樣(純伴奏)=ㄞㄑㄉㄇㄧ(ㄔㄅㄗ)
小星星=ㄒㄒㄒ
別怕我傷心=ㄅㄆㄨㄕㄒ
口是心非=ㄎㄕㄒㄈ
你的愛=ㄋㄉㄞ
每一次戀愛=ㄇㄧㄘㄌㄞ
大稻埕的天光=ㄉㄉㄔㄉㄊㄍ
我以為(純伴奏)=ㄨㄧㄨ(ㄔㄅㄗ)
熱帶雨林=ㄖㄉㄩㄌ
於是(純伴奏)=ㄩㄕ(ㄔㄅㄗ)
天地=ㄊㄉ
散=ㄙ
陳彥允=ㄔㄧㄩ
夏天的聖誕節=ㄒㄊㄉㄕㄉㄐ
梁詠琪=ㄌㄩㄑ
愛的燈火=ㄞㄉㄉㄏ
吼=ㄏ
想你的習慣=ㄒㄋㄉㄒㄍ
晚風=ㄨㄈ
失敗者的飛翔=ㄕㄅㄓㄉㄈㄒ
白藝潾=ㄅㄧㄌ
小酒窩(純伴奏)=ㄒㄐㄨ(ㄔㄅㄗ)
啦啦啦=ㄌㄌㄌ
心的距離=ㄒㄉㄐㄌ
等天光=ㄉㄊㄍ
田庄兄哥=ㄊㄓㄒㄍ
最近還好嗎=ㄗㄐㄏㄏㄇ
流沙(純伴奏)=ㄌㄕ(ㄔㄅㄗ)
怕安靜=ㄆㄢㄐ
剛剛好=ㄍㄍㄏ
祈禱平安=ㄑㄉㄆㄢ
一千萬次的淚水=ㄧㄑㄨㄘㄉㄌㄕ
情路看破=ㄑㄌㄎㄆ
走到飛=ㄗㄉㄈ
鬥牛要不要=ㄉㄋㄧㄅㄧ
恆星的恆心=ㄏㄒㄉㄏㄒ
曾經的你=ㄘㄐㄉㄋ
還隱隱作痛=ㄏㄧㄧㄗㄊ
沒有如果=ㄇㄧㄖㄍ
哭過就好了=ㄎㄍㄐㄏㄌ
林宥嘉,大象體操=ㄌㄧㄐ,ㄉㄒㄊㄘ
愛在夏天=ㄞㄗㄒㄊ
風兒輕輕吹=ㄈㄦㄑㄑㄔ
年少有為=ㄋㄕㄧㄨ
趙薇=ㄓㄨ
半句再見=ㄅㄐㄗㄐ
月夜愁=ㄩㄧㄔ
沒路=ㄇㄌ
遲來的愛(純伴奏)=ㄔㄌㄉㄞ(ㄔㄅㄗ)
我是你的(純伴奏)=ㄨㄕㄋㄉ(ㄔㄅㄗ)
不放=ㄅㄈ
繁花(純伴奏)=ㄈㄏ(ㄔㄅㄗ)
不愛了=ㄅㄞㄌ
蔡秋鳳=ㄘㄑㄈ
腳踏車(純伴奏)=ㄐㄊㄔ(ㄔㄅㄗ)
秘密基地=ㄇㄇㄐㄉ
說好各走五十步=ㄕㄏㄍㄗㄨㄕㄅ
痴情女=ㄔㄑㄋ
全部都給你(純伴奏)=ㄑㄅㄉㄍㄋ(ㄔㄅㄗ)
陳嘉樺,張軒睿=ㄔㄐㄏ,ㄓㄒㄖ
傻傻的=ㄕㄕㄉ
陌生人=ㄇㄕㄖ
繞=ㄖ
唐儷=ㄊㄌ
大雨將至=ㄉㄩㄐㄓ
這就是我愛你的方法=ㄓㄐㄕㄨㄞㄋㄉㄈㄈ
原來你不識愛過我=ㄩㄌㄋㄅㄕㄞㄍㄨ
愛是對的=ㄞㄕㄉㄉ
白小白=ㄅㄒㄅ
范瑋琪,韋禮安=ㄈㄨㄑ,ㄨㄌㄢ
給所有知道我名字的人=ㄍㄙㄧㄓㄉㄨㄇㄗㄉㄖ
怕什麼=ㄆㄕㄇ
喜樂河流=ㄒㄌㄏㄌ
查某囡仔=ㄔㄇㄋㄗ
周杰倫五月天阿信=ㄓㄐㄌㄨㄩㄊㄚㄒ
逆風飛翔=ㄋㄈㄈㄒ
隱隱寂寞=ㄧㄧㄐㄇ
誰來剪月光=ㄕㄌㄐㄩㄍ
洪雨雷=ㄏㄩㄌ
你會不會變=ㄋㄏㄅㄏㄅ
匆匆的走過=ㄘㄘㄉㄗㄍ
最好的安排=ㄗㄏㄉㄢㄆ
邱鋒澤,采子=ㄑㄈㄗ,ㄘㄗ
英雄=ㄧㄒ
飛翔=ㄈㄒ
不完美紳士=ㄅㄨㄇㄕㄕ
房東的貓=ㄈㄉㄉㄇ
苦海女神龍=ㄎㄏㄋㄕㄌ
信仰(純伴奏)=ㄒㄧ(ㄔㄅㄗ)
莊振凱,林俊吉,戴梅君=ㄓㄓㄎ,ㄌㄐㄐ,ㄉㄇㄐ
月滿西樓(純伴奏)=ㄩㄇㄒㄌ(ㄔㄅㄗ)
蘋果=ㄆㄍ
默念你=ㄇㄋㄋ
美麗的主題曲=ㄇㄌㄉㄓㄊㄑ
袂慣習=ㄇㄍㄒ
讓=ㄖ
東東(湯運煥)=ㄉㄉ(ㄊㄩㄏ)
一直一直愛=ㄧㄓㄧㄓㄞ
無聲仿有聲=ㄨㄕㄈㄧㄕ
看上她=ㄎㄕㄊ
東方神起=ㄉㄈㄕㄑ
情人的黃襯衫(純伴奏)=ㄑㄖㄉㄏㄔㄕ(ㄔㄅㄗ)
南屏晚鐘=ㄋㄆㄨㄓ
拆=ㄔ
李幸倪=ㄌㄒㄋ
因為你=ㄧㄨㄋ
每次都想呼喊妳的名字=ㄇㄘㄉㄒㄏㄏㄋㄉㄇㄗ
長城(純伴奏)=ㄔㄔ(ㄔㄅㄗ)
蔚雨芯=ㄨㄩㄒ
該放手了=ㄍㄈㄕㄌ
品冠=ㄆㄍ
不想(純伴奏)=ㄅㄒ(ㄔㄅㄗ)
王大文=ㄨㄉㄨ
心雨(純伴奏)=ㄒㄩ(ㄔㄅㄗ)
藏=ㄘ
今生的願望=ㄐㄕㄉㄩㄨ
激情過後=ㄐㄑㄍㄏ
夢中作憨人=ㄇㄓㄗㄏㄖ
飛啊飛=ㄈㄚㄈ
爺爺泡的茶=ㄧㄧㄆㄉㄔ
失眠=ㄕㄇ
招牌動作(純伴奏)=ㄓㄆㄉㄗ(ㄔㄅㄗ)
五月天,伍佰=ㄨㄩㄊ,ㄨㄅ
一時脆弱=ㄧㄕㄘㄖ
大太陽=ㄉㄊㄧ
最好=ㄗㄏ
鍾舒漫=ㄓㄕㄇ
突然之間(純伴奏)=ㄊㄖㄓㄐ(ㄔㄅㄗ)
是誰說過(純伴奏)=ㄕㄕㄕㄍ(ㄔㄅㄗ)
一見你就笑=ㄧㄐㄋㄐㄒ
就是這個時刻=ㄐㄕㄓㄍㄕㄎ
續緣=ㄒㄩ
真的嗎=ㄓㄉㄇ
四季謠=ㄙㄐㄧ
唯一(純伴奏)=ㄨㄧ(ㄔㄅㄗ)
對愛渴望=ㄉㄞㄎㄨ
爸爸親像山=ㄅㄅㄑㄒㄕ
鎖住時間=ㄙㄓㄕㄐ
座位=ㄗㄨ
相思雨(純伴奏)=ㄒㄙㄩ(ㄔㄅㄗ)
那不是雪中紅=ㄋㄅㄕㄒㄓㄏ
天地獨尊=ㄊㄉㄉㄗ
亂中秋=ㄌㄓㄑ
我也很想他=ㄨㄧㄏㄒㄊ
戀愛元氣彈=ㄌㄞㄩㄑㄊ
只對你有感覺(純伴奏)=ㄓㄉㄋㄧㄍㄐ(ㄔㄅㄗ)
嘸想你=ㄈㄒㄋ
說了再見=ㄕㄌㄗㄐ
若是有一天=ㄖㄕㄧㄧㄊ
不潮不用花錢=ㄅㄔㄅㄩㄏㄑ
草屯囝仔,玖壹壹洋蔥=ㄘㄊㄋㄗ,ㄐㄧㄧㄧㄘ
多情花=ㄉㄑㄏ
用生命所愛的人=ㄩㄕㄇㄙㄞㄉㄖ
迷霧=ㄇㄨ
甩一甩=ㄕㄧㄕ
愛你愛你(純伴奏)=ㄞㄋㄞㄋ(ㄔㄅㄗ)
風塵女=ㄈㄔㄋ
楊小萍=ㄧㄒㄆ
龍千玉,袁小迪=ㄌㄑㄩ,ㄩㄒㄉ
安守本份=ㄢㄕㄅㄈ
飯隨愛人(純伴奏)=ㄈㄙㄞㄖ(ㄔㄅㄗ)
我管你(真我版)=ㄨㄍㄋ(ㄓㄨㄅ)
傷心夜港邊(純伴奏)=ㄕㄒㄧㄍㄅ(ㄔㄅㄗ)
吉幾三=ㄐㄐㄙ
回鄉的我(純伴奏)=ㄏㄒㄉㄨ(ㄔㄅㄗ)
懶得管=ㄌㄉㄍ
好心分手(純伴奏)=ㄏㄒㄈㄕ(ㄔㄅㄗ)
明天的事情=ㄇㄊㄉㄕㄑ
勇敢一點=ㄩㄍㄧㄉ
祢愛降臨=ㄋㄞㄐㄌ
得不到你=ㄉㄅㄉㄋ
畢書盡=ㄅㄕㄐ
複製人=ㄈㄓㄖ
久保田利伸=ㄐㄅㄊㄌㄕ
音樂殖民地=ㄧㄩㄓㄇㄉ
一樣美麗=ㄧㄧㄇㄌ
再起東山=ㄗㄑㄉㄕ
沒有煙抽的日子=ㄇㄧㄧㄔㄉㄖㄗ
梁雁翎=ㄌㄧㄌ
陳雷=ㄔㄌ
恁姊仔住市內=ㄖㄐㄗㄓㄕㄋ
派對動物=ㄆㄉㄉㄨ
開不了口=ㄎㄅㄌㄎ
我安然居住=ㄨㄢㄖㄐㄓ
愛上你給的痛=ㄞㄕㄋㄍㄉㄊ
不死鳥=ㄅㄙㄋ
可以不可以=ㄎㄧㄅㄎㄧ
天使=ㄊㄕ
傷心味=ㄕㄒㄨ
阿爸原諒我=ㄚㄅㄩㄌㄨ
幸福不是情歌=ㄒㄈㄅㄕㄑㄍ
火種=ㄏㄓ
你是我胸口永遠的痛=ㄋㄕㄨㄒㄎㄩㄩㄉㄊ
溫泉鄉的情歌=ㄨㄑㄒㄉㄑㄍ
愛情大魔咒=ㄞㄑㄉㄇㄓ
想歸想=ㄒㄍㄒ
那些女孩教我的事=ㄋㄒㄋㄏㄐㄨㄉㄕ
星月神話=ㄒㄩㄕㄏ
渴望=ㄎㄨ
有一種愛叫等待(純伴奏)=ㄧㄧㄓㄞㄐㄉㄉ(ㄔㄅㄗ)
許廷鏗=ㄒㄊㄎ
愛不愛都寂寞=ㄞㄅㄞㄉㄐㄇ
偷心賊=ㄊㄒㄗ
不在=ㄅㄗ
於是長大了以後=ㄩㄕㄓㄉㄌㄧㄏ
曾靜玟吳玟芳=ㄘㄐㄨㄨㄨㄈ
傷心小站=ㄕㄒㄒㄓ
情書=ㄑㄕ
連名帶姓(純伴奏)=ㄌㄇㄉㄒ(ㄔㄅㄗ)
放肆黑夜=ㄈㄙㄏㄧ
賴富正=ㄌㄈㄓ
你是我心內的一首歌=ㄋㄕㄨㄒㄋㄉㄧㄕㄍ
愛内里菜三枝夕夏=ㄞㄋㄌㄘㄙㄓㄒㄒ
謝和弦王詩安=ㄒㄏㄒㄨㄕㄢ
不能說的秘密=ㄅㄋㄕㄉㄇㄇ
騎士精神=ㄑㄕㄐㄕ
小瓶子=ㄒㄆㄗ
平凡得可以=ㄆㄈㄉㄎㄧ
趁早(純伴奏)=ㄔㄗ(ㄔㄅㄗ)
再次將我更新=ㄗㄘㄐㄨㄍㄒ
葉啟田,方瑞娥=ㄧㄑㄊ,ㄈㄖㄜ
有情天音樂=ㄧㄑㄊㄧㄩ
海市蜃樓=ㄏㄕㄕㄌ
唯一的唯一=ㄨㄧㄉㄨㄧ
我還是一樣(純伴奏)=ㄨㄏㄕㄧㄧ(ㄔㄅㄗ)
牽引(純伴奏)=ㄑㄧ(ㄔㄅㄗ)
過我的生活=ㄍㄨㄉㄕㄏ
一輩子的孤單=ㄧㄅㄗㄉㄍㄉ
李昶俊=ㄌㄔㄐ
舊傷口=ㄐㄕㄎ
望秋風=ㄨㄑㄈ
黃義達=ㄏㄧㄉ
認錯=ㄖㄘ
片片楓葉片片情=ㄆㄆㄈㄧㄆㄆㄑ
林俊吉,楊靜=ㄌㄐㄐ,ㄧㄐ
領悟(純伴奏)=ㄌㄨ(ㄔㄅㄗ)
你沒愛過我=ㄋㄇㄞㄍㄨ
對不起我不愛你=ㄉㄅㄑㄨㄅㄞㄋ
在祢寶座前=ㄗㄋㄅㄗㄑ
匿名的好友=ㄋㄇㄉㄏㄧ
我等到花兒也謝了=ㄨㄉㄉㄏㄦㄧㄒㄌ
碰我的肩膀=ㄆㄨㄉㄐㄅ
金思頓的夢想=ㄐㄙㄉㄉㄇㄒ
一千個傷心的理由=ㄧㄑㄍㄕㄒㄉㄌㄧ
亞細亞的孤兒=ㄧㄒㄧㄉㄍㄦ
日子=ㄖㄗ
新的異象新的方向=ㄒㄉㄧㄒㄒㄉㄈㄒ
末班車=ㄇㄅㄔ
鋼琴鍵=ㄍㄑㄐ
到不了(純伴奏)=ㄉㄅㄌ(ㄔㄅㄗ)
女大田力小=ㄋㄉㄊㄌㄒ
隨意門=ㄙㄧㄇ
像我這樣的人=ㄒㄨㄓㄧㄉㄖ
伊晗=ㄧ晗
微微(純伴奏)=ㄨㄨ(ㄔㄅㄗ)
卡拉永遠(粵語)=ㄎㄌㄩㄩ(ㄩㄩ)
我會好好的=ㄨㄏㄏㄏㄉ
我愛過(純伴奏)=ㄨㄞㄍ(ㄔㄅㄗ)
虐心=ㄋㄒ
我愛他=ㄨㄞㄊ
最美=ㄗㄇ
一樣的月光=ㄧㄧㄉㄩㄍ
走著走著就散了=ㄗㄓㄗㄓㄐㄙㄌ
每次都想呼喊你的名字=ㄇㄘㄉㄒㄏㄏㄋㄉㄇㄗ
哪裡都是你=ㄋㄌㄉㄕㄋ
愛情當入樽=ㄞㄑㄉㄖㄗ
愛上自然的你=ㄞㄕㄗㄖㄉㄋ
逝去的諾言=ㄕㄑㄉㄋㄧ
我的好兄弟(純伴奏)=ㄨㄉㄏㄒㄉ(ㄔㄅㄗ)
不為誰而作的歌=ㄅㄨㄕㄦㄗㄉㄍ
旅姿三人男=ㄌㄗㄙㄖㄋ
羅時豐=ㄌㄕㄈ
鬼島=ㄍㄉ
失落沙洲(純伴奏)=ㄕㄌㄕㄓ(ㄔㄅㄗ)
菠蘿菠蘿蜜=ㄅㄌㄅㄌㄇ
在青春迷失的咖啡館=ㄗㄑㄔㄇㄕㄉㄎㄈㄍ
送行(純伴奏)=ㄙㄒ(ㄔㄅㄗ)
推開世界的門=ㄊㄎㄕㄐㄉㄇ
零点乐队=ㄌㄉㄌㄉ
誰想輕輕偷走我的吻=ㄕㄒㄑㄑㄊㄗㄨㄉㄨ
嘆雲兮=ㄊㄩㄒ
去吧=ㄑㄅ
傘下=ㄙㄒ
手中心=ㄕㄓㄒ
你還要我怎樣(純伴奏)=ㄋㄏㄧㄨㄗㄧ(ㄔㄅㄗ)
幸運女神=ㄒㄩㄋㄕ
敢要敢不要=ㄍㄧㄍㄅㄧ
雲中月圓=ㄩㄓㄩㄩ
心借過=ㄒㄐㄍ
有可能的夜晚=ㄧㄎㄋㄉㄧㄨ
我心內=ㄨㄒㄋ
隨堂測驗=ㄙㄊㄘㄧ
分分秒秒=ㄈㄈㄇㄇ
今天妳要嫁給我=ㄐㄊㄋㄧㄐㄍㄨ
冷冷聖誕節=ㄌㄌㄕㄉㄐ
喜帖街=ㄒㄊㄐ
愛似狂潮=ㄞㄙㄎㄔ
泰國情哥=ㄊㄍㄑㄍ
媽媽的話(純伴奏)=ㄇㄇㄉㄏ(ㄔㄅㄗ)
韓雪=ㄏㄒ
如果你也聽說=ㄖㄍㄋㄧㄊㄕ
感恩節=ㄍㄣㄐ
王傑,葉歡=ㄨㄐ,ㄧㄏ
起風了=ㄑㄈㄌ
錯愛的人=ㄘㄞㄉㄖ
王七七=ㄨㄑㄑ
為你寫首歌=ㄨㄋㄒㄕㄍ
如果有來生=ㄖㄍㄧㄌㄕ
聽爸爸的話=ㄊㄅㄅㄉㄏ
水水水=ㄕㄕㄕ
崑崙鏡=ㄎㄌㄐ
閻韋伶=ㄧㄨㄌ
傷心情歌=ㄕㄒㄑㄍ
療傷燒肉粽(純伴奏)=ㄌㄕㄕㄖㄗ(ㄔㄅㄗ)
牆外的風景=ㄑㄨㄉㄈㄐ
該忘了=ㄍㄨㄌ
想自由=ㄒㄗㄧ
唐儷,陳隨意=ㄊㄌ,ㄔㄙㄧ
大田後生仔(純伴奏)=ㄉㄊㄏㄕㄗ(ㄔㄅㄗ)
任蓉萱=ㄖㄖㄒ
吳思賢,范瑋琪=ㄨㄙㄒ,ㄈㄨㄑ
可不可以=ㄎㄅㄎㄧ
九月九的酒(純伴奏)=ㄐㄩㄐㄉㄐ(ㄔㄅㄗ)
無字的情批=ㄨㄗㄉㄑㄆ
毛不易=ㄇㄅㄧ
試圖生日快樂=ㄕㄊㄕㄖㄎㄌ
出嫁=ㄔㄐ
遠在咫尺=ㄩㄗㄓㄔ
冰點與沸點=ㄅㄉㄩㄈㄉ
陳奕迅王菲=ㄔㄧㄒㄨㄈ
食人夢=ㄕㄖㄇ
辛曉琪齊秦=ㄒㄒㄑㄑㄑ
玩具兵團要回家=ㄨㄐㄅㄊㄧㄏㄐ
想和你去吹吹風(純伴奏)=ㄒㄏㄋㄑㄔㄔㄈ(ㄔㄅㄗ)
葛仲珊比莉=ㄍㄓㄕㄅㄌ
曹格=ㄘㄍ
為你痴情為你迷=ㄨㄋㄔㄑㄨㄋㄇ
八代亜紀=ㄅㄉ亜ㄐ
趙鑫=ㄓㄒ
采子=ㄘㄗ
當店=ㄉㄉ
下雨的夜晚(純伴奏)=ㄒㄩㄉㄧㄨ(ㄔㄅㄗ)
分手後不要做朋友(純伴奏)=ㄈㄕㄏㄅㄧㄗㄆㄧ(ㄔㄅㄗ)
陳曉東林京燁=ㄔㄒㄉㄌㄐㄧ
蘇永康=ㄙㄩㄎ
枕邊人=ㄓㄅㄖ
無人之島(純伴奏)=ㄨㄖㄓㄉ(ㄔㄅㄗ)
多想=ㄉㄒ
等=ㄉ
挽仙桃=ㄨㄒㄊ
幸福離島=ㄒㄈㄌㄉ
父親寫的散文詩(純伴奏)=ㄈㄑㄒㄉㄙㄨㄕ(ㄔㄅㄗ)
阿雅(柳翰雅)=ㄚㄧ(ㄌㄏㄧ)
飲落去=ㄧㄌㄑ
小誤會=ㄒㄨㄏ
星降る街角=ㄒㄐるㄐㄐ
路過人間(純伴奏)=ㄌㄍㄖㄐ(ㄔㄅㄗ)
愛情少尉=ㄞㄑㄕㄨ
離開你走近你=ㄌㄎㄋㄗㄐㄋ
醒不來=ㄒㄅㄌ
因為有妳在=ㄧㄨㄧㄋㄗ
對你愛不完=ㄉㄋㄞㄅㄨ
寄生=ㄐㄕ
流星雨=ㄌㄒㄩ
愛要怎麼說出口=ㄞㄧㄗㄇㄕㄔㄎ
裏町酒場=ㄌㄊㄐㄔ
幾度夕陽紅=ㄐㄉㄒㄧㄏ
就這樣(純伴奏)=ㄐㄓㄧ(ㄔㄅㄗ)
傷心的人更傷心=ㄕㄒㄉㄖㄍㄕㄒ
謝和弦,王詩安=ㄒㄏㄒ,ㄨㄕㄢ
年輪(純伴奏)=ㄋㄌ(ㄔㄅㄗ)
李芷婷=ㄌㄓㄊ
暝那會這呢長=ㄇㄋㄏㄓㄋㄔ
慕容雪=ㄇㄖㄒ
這不是我=ㄓㄅㄕㄨ
愛死你=ㄞㄙㄋ
我愛洗澡=ㄨㄞㄒㄗ
劉德華柯受良吳宗憲=ㄌㄉㄏㄎㄕㄌㄨㄗㄒ
我願為你去=ㄨㄩㄨㄋㄑ
冰雨=ㄅㄩ
西北雨直直落(純伴奏)=ㄒㄅㄩㄓㄓㄌ(ㄔㄅㄗ)
困獸之鬥=ㄎㄕㄓㄉ
兄妹=ㄒㄇ
陽婆婆=ㄧㄆㄆ
說好不哭=ㄕㄏㄅㄎ
故鄉的月=ㄍㄒㄉㄩ
可樂=ㄎㄌ
逞強=ㄔㄑ
良一=ㄌㄧ
黃大城鍾麗莉=ㄏㄉㄔㄓㄌㄌ
祝福=ㄓㄈ
一直走(純伴奏)=ㄧㄓㄗ(ㄔㄅㄗ)
女人的愛情=ㄋㄖㄉㄞㄑ
哄我入睡=ㄏㄨㄖㄕ
純真年代=ㄔㄓㄋㄉ
別太溫柔=ㄅㄊㄨㄖ
老鼠愛大米=ㄌㄕㄞㄉㄇ
舞棍阿伯=ㄨㄍㄚㄅ
平快車=ㄆㄎㄔ
一無所懼=ㄧㄨㄙㄐ
男人傷=ㄋㄖㄕ
在一起=ㄗㄧㄑ
好眼淚壞眼淚=ㄏㄧㄌㄏㄧㄌ
如果這是我愛你最好的距離=ㄖㄍㄓㄕㄨㄞㄋㄗㄏㄉㄐㄌ
我們沒有在一起=ㄨㄇㄇㄧㄗㄧㄑ
周杰倫,張惠妹=ㄓㄐㄌ,ㄓㄏㄇ
蝴蝶之夏=ㄏㄉㄓㄒ
夜港邊=ㄧㄍㄅ
光輝歲月(粵語)=ㄍㄏㄙㄩ(ㄩㄩ)
復活=ㄈㄏ
愛情走那飛=ㄞㄑㄗㄋㄈ
午夜的戀歌=ㄨㄧㄉㄌㄍ
安娜的櫥窗(純伴奏)=ㄢㄋㄉㄔㄔ(ㄔㄅㄗ)
龍千玉=ㄌㄑㄩ
少年的我=ㄕㄋㄉㄨ
成功一定是咱的=ㄔㄍㄧㄉㄕㄗㄉ
我不會唱歌(純伴奏)=ㄨㄅㄏㄔㄍ(ㄔㄅㄗ)
現在我這麼想=ㄒㄗㄨㄓㄇㄒ
愛恨綿綿=ㄞㄏㄇㄇ
八公里=ㄅㄍㄌ
大家來乾一杯=ㄉㄐㄌㄍㄧㄅ
橘子汽水=ㄐㄗㄑㄕ
大皇帝=ㄉㄏㄉ
大山為我挪開=ㄉㄕㄨㄨㄋㄎ
黑澀會美眉=ㄏㄙㄏㄇㄇ
新的事將要成就=ㄒㄉㄕㄐㄧㄔㄐ
稻草=ㄉㄘ
你是我永遠的鄉愁=ㄋㄕㄨㄩㄩㄉㄒㄔ
心引力=ㄒㄧㄌ
想飛的自由落體=ㄒㄈㄉㄗㄧㄌㄊ
往事就是我的安慰(純伴奏)=ㄨㄕㄐㄕㄨㄉㄢㄨ(ㄔㄅㄗ)
斑馬斑馬=ㄅㄇㄅㄇ
玖壹壹洪春風=ㄐㄧㄧㄏㄔㄈ
今夜妳會不會來=ㄐㄧㄋㄏㄅㄏㄌ
然後怎樣=ㄖㄏㄗㄧ
我喜歡=ㄨㄒㄏ
淚水的盡頭=ㄌㄕㄉㄐㄊ
黃連煜=ㄏㄌㄩ
我是真的愛上你(純伴奏)=ㄨㄕㄓㄉㄞㄕㄋ(ㄔㄅㄗ)
療傷燒肉粽=ㄌㄕㄕㄖㄗ
思念到何時(純伴奏)=ㄙㄋㄉㄏㄕ(ㄔㄅㄗ)
三軍六校=ㄙㄐㄌㄒ
寂寞考=ㄐㄇㄎ
我就是這種女孩=ㄨㄐㄕㄓㄓㄋㄏ
七月涼山=ㄑㄩㄌㄕ
因著十架愛=ㄧㄓㄕㄐㄞ
兄弟本色=ㄒㄉㄅㄙ
幸福的嫁妝=ㄒㄈㄉㄐㄓ
邱鋒澤,陳零九=ㄑㄈㄗ,ㄔㄌㄐ
月娘的心肝=ㄩㄋㄉㄒㄍ
這樣的一個麻煩=ㄓㄧㄉㄧㄍㄇㄈ
龍千玉,曹西平=ㄌㄑㄩ,ㄘㄒㄆ
阿杰=ㄚㄐ
徳山秀典=徳ㄕㄒㄉ
嗶嗶嗶=ㄅㄅㄅ
到死都要歲=ㄉㄙㄉㄧㄙ
鬧鬧=ㄋㄋ
百年孤寂=ㄅㄋㄍㄐ
多少柔情多少淚(純伴奏)=ㄉㄕㄖㄑㄉㄕㄌ(ㄔㄅㄗ)
往事難追憶(純伴奏)=ㄨㄕㄋㄓㄧ(ㄔㄅㄗ)
青蘋果樂園=ㄑㄆㄍㄌㄩ
老教室=ㄌㄐㄕ
有一種勇氣叫放棄=ㄧㄧㄓㄩㄑㄐㄈㄑ
不害怕=ㄅㄏㄆ
給你=ㄍㄋ
其實(純伴奏)=ㄑㄕ(ㄔㄅㄗ)
我們(純伴奏)=ㄨㄇ(ㄔㄅㄗ)
蕭亞軒,黃立行=ㄒㄧㄒ,ㄏㄌㄒ
一步成詩=ㄧㄅㄔㄕ
心跳的證明(純伴奏)=ㄒㄊㄉㄓㄇ(ㄔㄅㄗ)
周思涵=ㄓㄙㄏ
布拉格廣場(純伴奏)=ㄅㄌㄍㄍㄔ(ㄔㄅㄗ)
就是我=ㄐㄕㄨ
習慣寂寞=ㄒㄍㄐㄇ
唯一的唯一的唯一=ㄨㄧㄉㄨㄧㄉㄨㄧ
想你的距離=ㄒㄋㄉㄐㄌ
好強=ㄏㄑ
五月天搶走我的女朋友=ㄨㄩㄊㄑㄗㄨㄉㄋㄆㄧ
太陽の花=ㄊㄧのㄏ
星河(純伴奏)=ㄒㄏ(ㄔㄅㄗ)
溫柔最痛=ㄨㄖㄗㄊ
你把我灌醉(純伴奏)=ㄋㄅㄨㄍㄗ(ㄔㄅㄗ)
不敢哭=ㄅㄍㄎ
愛就一個字=ㄞㄐㄧㄍㄗ
愛你愛甲心痛=ㄞㄋㄞㄐㄒㄊ
人情味=ㄖㄑㄨ
你是答案=ㄋㄕㄉㄢ
勉為其難=ㄇㄨㄑㄋ
黃宣=ㄏㄒ
收不回的愛=ㄕㄅㄏㄉㄞ
有一種悲傷(純伴奏)=ㄧㄧㄓㄅㄕ(ㄔㄅㄗ)
許景淳李之勤萬芳辛曉琪曹蘭潘儀君李度=ㄒㄐㄔㄌㄓㄑㄨㄈㄒㄒㄑㄘㄌㄆㄧㄐㄌㄉ
放生=ㄈㄕ
你還要我怎樣=ㄋㄏㄧㄨㄗㄧ
船碇=ㄔㄉ
可可托海的牧羊人(純伴奏)=ㄎㄎㄊㄏㄉㄇㄧㄖ(ㄔㄅㄗ)
海倫=ㄏㄌ
愛的飛行日記=ㄞㄉㄈㄒㄖㄐ
當蝴離開了蝶=ㄉㄏㄌㄎㄌㄉ
今生來世=ㄐㄕㄌㄕ
縱貫線=ㄗㄍㄒ
到不了=ㄉㄅㄌ
淡水暮色(純伴奏)=ㄉㄕㄇㄙ(ㄔㄅㄗ)
節拍器=ㄐㄆㄑ
唉呦我的媽=ㄞㄧㄨㄉㄇ
眉飛色舞(純伴奏)=ㄇㄈㄙㄨ(ㄔㄅㄗ)
女人都差不多=ㄋㄖㄉㄔㄅㄉ
飛兒樂團,彭佳慧=ㄈㄦㄩㄊ,ㄆㄐㄏ
擁抱你離去(純伴奏)=ㄩㄅㄋㄌㄑ(ㄔㄅㄗ)
張燕清戴梅君=ㄓㄧㄑㄉㄇㄐ
退後(純伴奏)=ㄊㄏ(ㄔㄅㄗ)
能不能留住你(純伴奏)=ㄋㄅㄋㄌㄓㄋ(ㄔㄅㄗ)
我愛妳(純伴奏)=ㄨㄞㄋ(ㄔㄅㄗ)
我的新衣=ㄨㄉㄒㄧ
相愛的方法=ㄒㄞㄉㄈㄈ
七分滿=ㄑㄈㄇ
一首簡單的歌=ㄧㄕㄐㄉㄉㄍ
張芸京=ㄓㄩㄐ
陳美鳳,江宏恩=ㄔㄇㄈ,ㄐㄏㄣ
夢什麼想=ㄇㄕㄇㄒ
英雄出少年=ㄧㄒㄔㄕㄋ
最難的夢=ㄗㄋㄉㄇ
你為什麼說謊=ㄋㄨㄕㄇㄕㄏ
高凌風=ㄍㄌㄈ
落雨聲=ㄌㄩㄕ
無情人有情天=ㄨㄑㄖㄧㄑㄊ
個情人節=ㄍㄑㄖㄐ
海闊天空(純伴奏)=ㄏㄎㄊㄎ(ㄔㄅㄗ)
許多年以後=ㄒㄉㄋㄧㄏ
陳淑萍徐立鴻=ㄔㄕㄆㄒㄌㄏ
王俊凱,蔡依林=ㄨㄐㄎ,ㄘㄧㄌ
如果再見=ㄖㄍㄗㄐ
港町十三番地=ㄍㄊㄕㄙㄈㄉ
聚散倆依依=ㄐㄙㄌㄧㄧ
毒蘋果=ㄉㄆㄍ
客家人=ㄎㄐㄖ
不會愛就別愛=ㄅㄏㄞㄐㄅㄞ
路過人間=ㄌㄍㄖㄐ
讓讚美飛揚=ㄖㄗㄇㄈㄧ
我們快樂地向前走=ㄨㄇㄎㄌㄉㄒㄑㄗ
我們不要傷心了=ㄨㄇㄅㄧㄕㄒㄌ
選擇=ㄒㄗ
孩子王=ㄏㄗㄨ
我們一起走，好嗎=ㄨㄇㄧㄑㄗ，ㄏㄇ
浪漫手機=ㄌㄇㄕㄐ
送你一把泥土=ㄙㄋㄧㄅㄋㄊ
肉麻情歌=ㄖㄇㄑㄍ
不才=ㄅㄘ
愛情真言=ㄞㄑㄓㄧ
楊燕=ㄧㄧ
招牌動作=ㄓㄆㄉㄗ
鳳凰傳奇=ㄈㄏㄔㄑ
兩隻老虎(純伴奏)=ㄌㄓㄌㄏ(ㄔㄅㄗ)
陌生的地方=ㄇㄕㄉㄉㄈ
嘆雲兮(純伴奏)=ㄊㄩㄒ(ㄔㄅㄗ)
對不對=ㄉㄅㄉ
一夜情(純伴奏)=ㄧㄧㄑ(ㄔㄅㄗ)
賀敬軒=ㄏㄐㄒ
我們的故事只講了一半=ㄨㄇㄉㄍㄕㄓㄐㄌㄧㄅ
醫治恩流=ㄧㄓㄣㄌ
零缺點=ㄌㄑㄉ
仇敵滾出去=ㄔㄉㄍㄔㄑ
新耶路撒冷=ㄒㄧㄌㄙㄌ
嗯=ㄣ
彩虹眼淚=ㄘㄏㄧㄌ
一天一萬年=ㄧㄊㄧㄨㄋ
零下幾度=ㄌㄒㄐㄉ
瀟灑小姐=ㄒㄙㄒㄐ
阿爸原諒我(純伴奏)=ㄚㄅㄩㄌㄨ(ㄔㄅㄗ)
難忘台西港=ㄋㄨㄊㄒㄍ
芒種=ㄇㄓ
王一博=ㄨㄧㄅ
芥菜種音樂小站=ㄐㄘㄓㄧㄩㄒㄓ
美人計=ㄇㄖㄐ
靠北=ㄎㄅ
台灣餘位華語歌手共同錄唱=ㄊㄨㄩㄨㄏㄩㄍㄕㄍㄊㄌㄔ
下雨天的週末=ㄒㄩㄊㄉㄓㄇ
第幾個天=ㄉㄐㄍㄊ
離別=ㄌㄅ
汪蘇瀧=ㄨㄙㄌ
我要愛慕你=ㄨㄧㄞㄇㄋ
心‧洞=ㄒ‧ㄉ
跟往事乾杯=ㄍㄨㄕㄍㄅ
愛妳一世人=ㄞㄋㄧㄕㄖ
羅志祥小=ㄌㄓㄒㄒ
聽說你要走(純伴奏)=ㄊㄕㄋㄧㄗ(ㄔㄅㄗ)
嫁娶=ㄐㄑ
許茹芸=ㄒㄖㄩ
馬德里不思議=ㄇㄉㄌㄅㄙㄧ
郭正正,=ㄍㄓㄓ,
煙花=ㄧㄏ
不放手=ㄅㄈㄕ
山坡上的薩滿=ㄕㄆㄕㄉㄙㄇ
洪第七=ㄏㄉㄑ
酒矸倘賣無=ㄐㄍㄊㄇㄨ
我是如此愛你=ㄨㄕㄖㄘㄞㄋ
兜圈=ㄉㄑ
缺口=ㄑㄎ
父親寫的散文詩=ㄈㄑㄒㄉㄙㄨㄕ
快樂每一天(熊大農場主題曲)=ㄎㄌㄇㄧㄊ(ㄒㄉㄋㄔㄓㄊㄑ)
夏之旅=ㄒㄓㄌ
達拉崩吧(純伴奏)=ㄉㄌㄅㄅ(ㄔㄅㄗ)
此時快樂的代價=ㄘㄕㄎㄌㄉㄉㄐ
何雁詩=ㄏㄧㄕ
愛丫愛丫=ㄞㄧㄞㄧ
風櫃來的人=ㄈㄍㄌㄉㄖ
大雨將至(純伴奏)=ㄉㄩㄐㄓ(ㄔㄅㄗ)
有多少愛可以重來(純伴奏)=ㄧㄉㄕㄞㄎㄧㄔㄌ(ㄔㄅㄗ)
有你就有我=ㄧㄋㄐㄧㄨ
不哭=ㄅㄎ
認份=ㄖㄈ
燒肉粽=ㄕㄖㄗ
對峙=ㄉㄓ
黃致列=ㄏㄓㄌ
傷日快樂=ㄕㄖㄎㄌ
十字架=ㄕㄗㄐ
勇敢去愛(純伴奏)=ㄩㄍㄑㄞ(ㄔㄅㄗ)
我們的愛=ㄨㄇㄉㄞ
海の幽霊=ㄏのㄧ霊
把愛傳出來=ㄅㄞㄔㄔㄌ
愛是永恆=ㄞㄕㄩㄏ
專家模式(純伴奏)=ㄓㄐㄇㄕ(ㄔㄅㄗ)
玫瑰少年(純伴奏)=ㄇㄍㄕㄋ(ㄔㄅㄗ)
最後才知影=ㄗㄏㄘㄓㄧ
赤崁樓之戀=ㄔㄎㄌㄓㄌ
黃明志動力火車=ㄏㄇㄓㄉㄌㄏㄔ
王詩安=ㄨㄕㄢ
夢中人=ㄇㄓㄖ
五月天,黃渤=ㄨㄩㄊ,ㄏㄅ
何必記念=ㄏㄅㄐㄋ
於是=ㄩㄕ
鄧妙華,孫建平=ㄉㄇㄏ,ㄙㄐㄆ
永遠敬拜=ㄩㄩㄐㄅ
五音嵐之調澈心=ㄨㄧㄌㄓㄊㄔㄒ
是否能看懂=ㄕㄈㄋㄎㄉ
蔣蔣楊清檸=ㄐㄐㄧㄑㄋ
淘汰(純伴奏)=ㄊㄊ(ㄔㄅㄗ)
成全我的愛=ㄔㄑㄨㄉㄞ
從今開始=ㄘㄐㄎㄕ
其實不想走(純伴奏)=ㄑㄕㄅㄒㄗ(ㄔㄅㄗ)
如果那天你說愛我=ㄖㄍㄋㄊㄋㄕㄞㄨ
燒情歌=ㄕㄑㄍ
！敢傻就飛！=！ㄍㄕㄐㄈ！
光著我的腳ㄚ子=ㄍㄓㄨㄉㄐㄚㄗ
煙火裡的塵埃(純伴奏)=ㄧㄏㄌㄉㄔㄞ(ㄔㄅㄗ)
顧媚=ㄍㄇ
一首搖滾上月球=ㄧㄕㄧㄍㄕㄩㄑ
可能否=ㄎㄋㄈ
晨間新聞=ㄔㄐㄒㄨ
鄭文魁=ㄓㄨㄎ
其實不想走=ㄑㄕㄅㄒㄗ
愛,存在=ㄞ,ㄘㄗ
陳壹千=ㄔㄧㄑ
真心英雄=ㄓㄒㄧㄒ
這首歌=ㄓㄕㄍ
十架的愛=ㄕㄐㄉㄞ
不一樣又怎樣=ㄅㄧㄧㄧㄗㄧ
看穿=ㄎㄔ
一路向北(純伴奏)=ㄧㄌㄒㄅ(ㄔㄅㄗ)
愛我到今生(純伴奏)=ㄞㄨㄉㄐㄕ(ㄔㄅㄗ)
愛的箴言=ㄞㄉㄓㄧ
純真#=ㄔㄓ#
以前，以後(純伴奏)=ㄧㄑ，ㄧㄏ(ㄔㄅㄗ)
牛奶麵包(純伴奏)=ㄋㄋㄇㄅ(ㄔㄅㄗ)
一朵花=ㄧㄉㄏ
鄭鈞=ㄓㄐ
快來快來約我=ㄎㄌㄎㄌㄩㄨ
我想要的感覺=ㄨㄒㄧㄉㄍㄐ
姚蘇蓉=ㄧㄙㄖ
最美的期待=ㄗㄇㄉㄑㄉ
林育羣=ㄌㄩㄑ
柳丁哥哥,橘子姐姐=ㄌㄉㄍㄍ,ㄐㄗㄐㄐ
我親愛的你=ㄨㄑㄞㄉㄋ
狼=ㄌ
賴慧如,許仁杰=ㄌㄏㄖ,ㄒㄖㄐ
蘇盈之=ㄙㄧㄓ
溫柔的拒絕=ㄨㄖㄉㄐㄐ
雲霄飛車=ㄩㄒㄈㄔ
不遠的情人=ㄅㄩㄉㄑㄖ
露水=ㄌㄕ
我庄=ㄨㄓ
獨角戲=ㄉㄐㄒ
老街=ㄌㄐ
思慕=ㄙㄇ
蝴蝶飛呀=ㄏㄉㄈㄧ
亮了=ㄌㄌ
愛自己=ㄞㄗㄐ
郭靜=ㄍㄐ
心型圈=ㄒㄒㄑ
那一刻心動=ㄋㄧㄎㄒㄉ
少一點天份=ㄕㄧㄉㄊㄈ
你的肩膀=ㄋㄉㄐㄅ
神度(純伴奏)=ㄕㄉ(ㄔㄅㄗ)
離開後=ㄌㄎㄏ
陶大偉=ㄊㄉㄨ
天使之戀=ㄊㄕㄓㄌ
愛到最後一秒也不委曲=ㄞㄉㄗㄏㄧㄇㄧㄅㄨㄑ
秋水長天=ㄑㄕㄔㄊ
張洪量,莫文蔚=ㄓㄏㄌ,ㄇㄨㄨ
愛你的兩個我(純伴奏)=ㄞㄋㄉㄌㄍㄨ(ㄔㄅㄗ)
我多喜歡你,你會知道=ㄨㄉㄒㄏㄋ,ㄋㄏㄓㄉ
我還年輕我還年輕(純伴奏)=ㄨㄏㄋㄑㄨㄏㄋㄑ(ㄔㄅㄗ)
蔡振南=ㄘㄓㄋ
冷井情深(純伴奏)=ㄌㄐㄑㄕ(ㄔㄅㄗ)
因為我愛你=ㄧㄨㄨㄞㄋ
連貝多芬都想告訴你=ㄌㄅㄉㄈㄉㄒㄍㄙㄋ
你不在(純伴奏)=ㄋㄅㄗ(ㄔㄅㄗ)
伍思凱=ㄨㄙㄎ
旅行的意義=ㄌㄒㄉㄧㄧ
許書豪=ㄒㄕㄏ
戒痕=ㄐㄏ
任家萱=ㄖㄐㄒ
灰色軌跡(純伴奏)=ㄏㄙㄍㄐ(ㄔㄅㄗ)
越來越愛你=ㄩㄌㄩㄞㄋ
,王忻辰=,ㄨㄒㄔ
龍飄飄=ㄌㄆㄆ
用餘生去愛=ㄩㄩㄕㄑㄞ
決心對你行=ㄐㄒㄉㄋㄒ
劉嘉玲=ㄌㄐㄌ
多想留在你身邊=ㄉㄒㄌㄗㄋㄕㄅ
想你的習慣(純伴奏)=ㄒㄋㄉㄒㄍ(ㄔㄅㄗ)
目不轉睛(純伴奏)=ㄇㄅㄓㄐ(ㄔㄅㄗ)
對愛投降=ㄉㄞㄊㄒ
柯智棠=ㄎㄓㄊ
回來我身邊=ㄏㄌㄨㄕㄅ
嵐=ㄌ
讓我們看雲去=ㄖㄨㄇㄎㄩㄑ
寒心=ㄏㄒ
早班火車(純伴奏)=ㄗㄅㄏㄔ(ㄔㄅㄗ)
頭髮亂了(純伴奏)=ㄊㄈㄌㄌ(ㄔㄅㄗ)
撕夜=ㄙㄧ
我不願讓你一個人=ㄨㄅㄩㄖㄋㄧㄍㄖ
一夜長大=ㄧㄧㄓㄉ
大齡女子=ㄉㄌㄋㄗ
最浪漫的事=ㄗㄌㄇㄉㄕ
周慧敏林隆璇=ㄓㄏㄇㄌㄌㄒ
秋蟬=ㄑㄔ
謝金晶,翁立友=ㄒㄐㄐ,ㄨㄌㄧ
珍重=ㄓㄓ
朱俐靜=ㄓㄌㄐ
狂風裡擁抱=ㄎㄈㄌㄩㄅ
曾軼可=ㄘㄧㄎ
季軍=ㄐㄐ
把悲傷留給自己=ㄅㄅㄕㄌㄍㄗㄐ
呼召=ㄏㄓ
林子祥,葉蒨文=ㄌㄗㄒ,ㄧㄑㄨ
愛我還是伊=ㄞㄨㄏㄕㄧ
三生有幸=ㄙㄕㄧㄒ
好男人=ㄏㄋㄖ
塵緣=ㄔㄩ
壞的好人=ㄏㄉㄏㄖ
自導自演=ㄗㄉㄗㄧ
野鳥=ㄧㄋ
鳳娘=ㄈㄋ
平凡明星=ㄆㄈㄇㄒ
東京鐵塔的幸福=ㄉㄐㄊㄊㄉㄒㄈ
非常女=ㄈㄔㄋ
不是真的愛我=ㄅㄕㄓㄉㄞㄨ
李國毅=ㄌㄍㄧ
夜夜夜夜=ㄧㄧㄧㄧ
下個街角=ㄒㄍㄐㄐ
救世間=ㄐㄕㄐ
心花開=ㄒㄏㄎ
夢一場=ㄇㄧㄔ
蔡小虎=ㄘㄒㄏ
做一天的你=ㄗㄧㄊㄉㄋ
和田光司=ㄏㄊㄍㄙ
鄭智化=ㄓㄓㄏ
劉德華,柯受良,吳宗憲=ㄌㄉㄏ,ㄎㄕㄌ,ㄨㄗㄒ
有夢可待(純伴奏)=ㄧㄇㄎㄉ(ㄔㄅㄗ)
翁立友=ㄨㄌㄧ
愛相隨=ㄞㄒㄙ
當我們宅一塊(純伴奏)=ㄉㄨㄇㄓㄧㄎ(ㄔㄅㄗ)
猜不透(純伴奏)=ㄘㄅㄊ(ㄔㄅㄗ)
\=\
原野三重唱=ㄩㄧㄙㄔㄔ
手心的薔薇=ㄕㄒㄉㄑㄨ
情網=ㄑㄨ
流浪者的獨白=ㄌㄌㄓㄉㄉㄅ
鴨子=ㄧㄗ
洪榮宏,林為音=ㄏㄖㄏ,ㄌㄨㄧ
窗=ㄔ
我們盡力了=ㄨㄇㄐㄌㄌ
後街人生=ㄏㄐㄖㄕ
大地回春(純伴奏)=ㄉㄉㄏㄔ(ㄔㄅㄗ)
有沒有(純伴奏)=ㄧㄇㄧ(ㄔㄅㄗ)
帶刺的蓓蕾=ㄉㄘㄉㄅㄌ
狐狸精=ㄏㄌㄐ
丁香花=ㄉㄒㄏ
寂寞=ㄐㄇ
大田後生仔=ㄉㄊㄏㄕㄗ
牡丹江=ㄇㄉㄐ
聖誕快樂=ㄕㄉㄎㄌ
九號球=ㄐㄏㄑ
帥到分手=ㄕㄉㄈㄕ
風真透(純伴奏)=ㄈㄓㄊ(ㄔㄅㄗ)
受夠=ㄕㄍ
蔡義德,張政雄=ㄘㄧㄉ,ㄓㄓㄒ
蘭花草=ㄌㄏㄘ
敘述=ㄒㄕ
你曾經愛過我=ㄋㄘㄐㄞㄍㄨ
倒帶=ㄉㄉ
恐怖情人=ㄎㄅㄑㄖ
廖柏雅=ㄌㄅㄧ
女人淚=ㄋㄖㄌ
致姍姍來遲的你(純伴奏)=ㄓㄕㄕㄌㄔㄉㄋ(ㄔㄅㄗ)
內山的姑娘=ㄋㄕㄉㄍㄋ
多少柔情多少淚=ㄉㄕㄖㄑㄉㄕㄌ
歸去來=ㄍㄑㄌ
\謝謝=\ㄒㄒ
小男孩樂團=ㄒㄋㄏㄩㄊ
醜八怪=ㄔㄅㄍ
以前，以後=ㄧㄑ，ㄧㄏ
為你變成他=ㄨㄋㄅㄔㄊ
凡人(純伴奏)=ㄈㄖ(ㄔㄅㄗ)
碼頭惜別=ㄇㄊㄒㄅ
淚光閃爍=ㄌㄍㄕㄕ
花太香=ㄏㄊㄒ
黑擇明=ㄏㄗㄇ
每天的禱告=ㄇㄊㄉㄉㄍ
你曾經愛過我(純伴奏)=ㄋㄘㄐㄞㄍㄨ(ㄔㄅㄗ)
愛已走遠=ㄞㄧㄗㄩ
壘上的相逢=ㄌㄕㄉㄒㄈ
明明愛你=ㄇㄇㄞㄋ
明天我要嫁給你=ㄇㄊㄨㄧㄐㄍㄋ
安靜=ㄢㄐ
掌心=ㄓㄒ
愛和承諾=ㄞㄏㄔㄋ
拋物線=ㄆㄨㄒ
害怕=ㄏㄆ
有心人痴情夢=ㄧㄒㄖㄔㄑㄇ
台灣的心跳聲=ㄊㄨㄉㄒㄊㄕ
放手去做=ㄈㄕㄑㄗ
我想忘了你=ㄨㄒㄨㄌㄋ
喜酒三杯=ㄒㄐㄙㄅ
方瑞娥=ㄈㄖㄜ
葛仲珊=ㄍㄓㄕ
眼淚=ㄧㄌ
任子墨=ㄖㄗㄇ
南台灣小姑娘=ㄋㄊㄨㄒㄍㄋ
今天愛了沒=ㄐㄊㄞㄌㄇ
突然之間=ㄊㄖㄓㄐ
懸日(純伴奏)=ㄒㄖ(ㄔㄅㄗ)
七十億分之一加一(純伴奏)=ㄑㄕㄧㄈㄓㄧㄐㄧ(ㄔㄅㄗ)
尚好的青春=ㄕㄏㄉㄑㄔ
神奇化妝師=ㄕㄑㄏㄓㄕ
在幸福的路上=ㄗㄒㄈㄉㄌㄕ
周杰倫,費玉清=ㄓㄐㄌ,ㄈㄩㄑ
超跑女神=ㄔㄆㄋㄕ
了不起寂寞=ㄌㄅㄑㄐㄇ
閆澤歡=ㄧㄗㄏ
安靜(純伴奏)=ㄢㄐ(ㄔㄅㄗ)
真心的戀夢=ㄓㄒㄉㄌㄇ
五月天=ㄨㄩㄊ
孫淑媚,王識賢=ㄙㄕㄇ,ㄨㄕㄒ
天星伴天涯=ㄊㄒㄅㄊㄧ
張聖子張耀輝=ㄓㄕㄗㄓㄧㄏ
于果=ㄩㄍ
偉大的渺小=ㄨㄉㄉㄇㄒ
今夜我想喝醉=ㄐㄧㄨㄒㄏㄗ
情書(純伴奏)=ㄑㄕ(ㄔㄅㄗ)
杯中影=ㄅㄓㄧ
翻轉地球=ㄈㄓㄉㄑ
擱淺=ㄍㄑ
耶和華作了我的高臺\=ㄧㄏㄏㄗㄌㄨㄉㄍㄊ\
蔡以真=ㄘㄧㄓ
我不會喜歡你=ㄨㄅㄏㄒㄏㄋ
半斤八兩(純伴奏)=ㄅㄐㄅㄌ(ㄔㄅㄗ)
梁文音=ㄌㄨㄧ
冷暖人生=ㄌㄋㄖㄕ
一生愛你千百回=ㄧㄕㄞㄋㄑㄅㄏ
愛的可能(純伴奏)=ㄞㄉㄎㄋ(ㄔㄅㄗ)
平常心=ㄆㄔㄒ
聲聲慢=ㄕㄕㄇ
我何必=ㄨㄏㄅ
甲你攬牢牢(純伴奏)=ㄐㄋㄌㄌㄌ(ㄔㄅㄗ)
自然醒=ㄗㄖㄒ
觀眾(純伴奏)=ㄍㄓ(ㄔㄅㄗ)
愛我別走=ㄞㄨㄅㄗ
一見鍾情=ㄧㄐㄓㄑ
露水情=ㄌㄕㄑ
無情還乎你=ㄨㄑㄏㄏㄋ
諾亞方舟=ㄋㄧㄈㄓ
燃燒一瞬間=ㄖㄕㄧㄕㄐ
暗黑白領階級=ㄢㄏㄅㄌㄐㄐ
重來=ㄔㄌ
十萬毫升淚水(純伴奏)=ㄕㄨㄏㄕㄌㄕ(ㄔㄅㄗ)
忘川河(純伴奏)=ㄨㄔㄏ(ㄔㄅㄗ)
翁倩玉=ㄨㄑㄩ
囂張=ㄒㄓ
讓愛走動=ㄖㄞㄗㄉ
月圓情=ㄩㄩㄑ
摩天輪的思念=ㄇㄊㄌㄉㄙㄋ
命運青紅燈=ㄇㄩㄑㄏㄉ
漂浪之女=ㄆㄌㄓㄋ
牽心萬苦(純伴奏)=ㄑㄒㄨㄎ(ㄔㄅㄗ)
寂寞情歌=ㄐㄇㄑㄍ
一支小雨傘(純伴奏)=ㄧㄓㄒㄩㄙ(ㄔㄅㄗ)
王藍茵=ㄨㄌㄧ
我曾(純伴奏)=ㄨㄘ(ㄔㄅㄗ)
時代佳人=ㄕㄉㄐㄖ
寵愛(純伴奏)=ㄔㄞ(ㄔㄅㄗ)
探獄思君怨=ㄊㄩㄙㄐㄩ
阿嬤的話=ㄚㄇㄉㄏ
唇語=ㄔㄩ
醜八怪(純伴奏)=ㄔㄅㄍ(ㄔㄅㄗ)
死灰復燃=ㄙㄏㄈㄖ
鄭秀文,八三夭=ㄓㄒㄨ,ㄅㄙㄧ
李千那=ㄌㄑㄋ
閃亮的星=ㄕㄌㄉㄒ
臉=ㄌ
波止場氣質=ㄆㄓㄔㄑㄓ
尚水的伴=ㄕㄕㄉㄅ
吳俊宏=ㄨㄐㄏ
生龍活虎打衝鋒=ㄕㄌㄏㄏㄉㄔㄈ
體面(純伴奏)=ㄊㄇ(ㄔㄅㄗ)
還是會想他=ㄏㄕㄏㄒㄊ
演員=ㄧㄩ
當愛已成往事=ㄉㄞㄧㄔㄨㄕ
割愛=ㄍㄞ
魚乾=ㄩㄍ
鍊愛(純伴奏)=ㄌㄞ(ㄔㄅㄗ)
李健=ㄌㄐ
譚艷=ㄊㄧ
聖誕路人=ㄕㄉㄌㄖ
我的快樂時代=ㄨㄉㄎㄌㄕㄉ
乾妹妹=ㄍㄇㄇ
兩個冬天=ㄌㄍㄉㄊ
馮偉傑=ㄈㄨㄐ
余天,李亞萍=ㄩㄊ,ㄌㄧㄆ
迷失幻境=ㄇㄕㄏㄐ
周杰倫,曾志偉,麥烝瑋,雪糕,袁詠琳=ㄓㄐㄌ,ㄘㄓㄨ,ㄇㄓㄨ,ㄒㄍ,ㄩㄩㄌ
今天睡在這裡=ㄐㄊㄕㄗㄓㄌ
離開以後=ㄌㄎㄧㄏ
帶我去找夜生活(純伴奏)=ㄉㄨㄑㄓㄧㄕㄏ(ㄔㄅㄗ)
畢竟深愛過(純伴奏)=ㄅㄐㄕㄞㄍ(ㄔㄅㄗ)
米津玄師=ㄇㄐㄒㄕ
不想伊=ㄅㄒㄧ
樂瞳=ㄌㄊ
你一定要幸福=ㄋㄧㄉㄧㄒㄈ
夢醒在天涯=ㄇㄒㄗㄊㄧ
小羊詩歌=ㄒㄧㄕㄍ
大魚=ㄉㄩ
出外靠朋友=ㄔㄨㄎㄆㄧ
我知道你很難過=ㄨㄓㄉㄋㄏㄋㄍ
容祖兒,羅志祥=ㄖㄗㄦ,ㄌㄓㄒ
好的情人=ㄏㄉㄑㄖ
這一生關於你的風景=ㄓㄧㄕㄍㄩㄋㄉㄈㄐ
忍不住想念=ㄖㄅㄓㄒㄋ
忘記=ㄨㄐ
台灣那麼旺=ㄊㄨㄋㄇㄨ
深海=ㄕㄏ
你是我兄弟=ㄋㄕㄨㄒㄉ
陳琳=ㄔㄌ
世間美好與你環環相扣=ㄕㄐㄇㄏㄩㄋㄏㄏㄒㄎ
錢錢錢=ㄑㄑㄑ
聖結石,黃美珍=ㄕㄐㄕ,ㄏㄇㄓ
流連=ㄌㄌ
逗陣兄弟=ㄉㄓㄒㄉ
半醉人生=ㄅㄗㄖㄕ
渡紅塵=ㄉㄏㄔ
彭佳慧=ㄆㄐㄏ
我對不起我=ㄨㄉㄅㄑㄨ
鞠婧禕=ㄐㄐㄧ
(純伴奏)=(ㄔㄅㄗ)
你那麼愛她(純伴奏)=ㄋㄋㄇㄞㄊ(ㄔㄅㄗ)
娃娃愛天下=ㄨㄨㄞㄊㄒ
戴佩妮=ㄉㄆㄋ
甭擱想彼多=ㄅㄍㄒㄅㄉ
溫嵐=ㄨㄌ
色誡=ㄙㄐ
不如這樣=ㄅㄖㄓㄧ
你是風兒我是沙=ㄋㄕㄈㄦㄨㄕㄕ
習慣晚睡(純伴奏)=ㄒㄍㄨㄕ(ㄔㄅㄗ)
謎路人=ㄇㄌㄖ
夜空中最亮的星=ㄧㄎㄓㄗㄌㄉㄒ
同一種調調=ㄊㄧㄓㄉㄉ
往事難追憶=ㄨㄕㄋㄓㄧ
盟約=ㄇㄩ
龐龍=ㄆㄌ
命運點歌=ㄇㄩㄉㄍ
一個人跳舞=ㄧㄍㄖㄊㄨ
枕頭香=ㄓㄊㄒ
劉若英=ㄌㄖㄧ
恋人よ=ㄌㄖよ
無聲仿有聲(純伴奏)=ㄨㄕㄈㄧㄕ(ㄔㄅㄗ)
家家歌=ㄐㄐㄍ
解偉苓=ㄐㄨㄌ
陳曉東=ㄔㄒㄉ
讓我守護妳=ㄖㄨㄕㄏㄋ
早安台灣=ㄗㄢㄊㄨ
我願意=ㄨㄩㄧ
你還是我最深愛的人=ㄋㄏㄕㄨㄗㄕㄞㄉㄖ
好心分手=ㄏㄒㄈㄕ
痛苦女人心=ㄊㄎㄋㄖㄒ
一個人想著一個人(純伴奏)=ㄧㄍㄖㄒㄓㄧㄍㄖ(ㄔㄅㄗ)
雙刀=ㄕㄉ
輪迴=ㄌㄏ
悲歌王=ㄅㄍㄨ
為你夢為你等=ㄨㄋㄇㄨㄋㄉ
江水向東流(純伴奏)=ㄐㄕㄒㄉㄌ(ㄔㄅㄗ)
這樣也好=ㄓㄧㄧㄏ
出去走走(高雄觀光主題曲)=ㄔㄑㄗㄗ(ㄍㄒㄍㄍㄓㄊㄑ)
慣性取暖=ㄍㄒㄑㄋ
恆溫=ㄏㄨ
阿肆,林宥嘉=ㄚㄙ,ㄌㄧㄐ
頑童=ㄨㄊ
晚安,吾愛=ㄨㄢ,ㄨㄞ
隱形超人=ㄧㄒㄔㄖ
戀曲(純伴奏)=ㄌㄑ(ㄔㄅㄗ)
蝴蝶飛=ㄏㄉㄈ
像女孩的女人=ㄒㄋㄏㄉㄋㄖ
愛情=ㄞㄑ
朱海君,李明洋=ㄓㄏㄐ,ㄌㄇㄧ
鋼鐵心=ㄍㄊㄒ
和平與愛=ㄏㄆㄩㄞ
一卡手指=ㄧㄎㄕㄓ
那一夜我喝了酒=ㄋㄧㄧㄨㄏㄌㄐ
我要你過得好=ㄨㄧㄋㄍㄉㄏ
丟了你(純伴奏)=ㄉㄌㄋ(ㄔㄅㄗ)
故事=ㄍㄕ
才知我的痛=ㄘㄓㄨㄉㄊ
落大雨彼一日=ㄌㄉㄩㄅㄧㄖ
人生就是戲=ㄖㄕㄐㄕㄒ
單身情歌(純伴奏)=ㄉㄕㄑㄍ(ㄔㄅㄗ)
四不像=ㄙㄅㄒ
我心似清泉=ㄨㄒㄙㄑㄑ
話題=ㄏㄊ
雪花夢=ㄒㄏㄇ
我是一棵秋天的樹=ㄨㄕㄧㄎㄑㄊㄉㄕ
愛情轉移(純伴奏)=ㄞㄑㄓㄧ(ㄔㄅㄗ)
回味=ㄏㄨ
ㄅㄆㄇ注音歌=ㄅㄆㄇㄓㄧㄍ
孫悟空(純伴奏)=ㄙㄨㄎ(ㄔㄅㄗ)
信仰=ㄒㄧ
倒帶(純伴奏)=ㄉㄉ(ㄔㄅㄗ)
愛如意=ㄞㄖㄧ
情一動心就痛(純伴奏)=ㄑㄧㄉㄒㄐㄊ(ㄔㄅㄗ)
戀愛頻率=ㄌㄞㄆㄌ
最美情侶(純伴奏)=ㄗㄇㄑㄌ(ㄔㄅㄗ)
愛太空=ㄞㄊㄎ
壞人(純伴奏)=ㄏㄖ(ㄔㄅㄗ)
明仔載(正式版)=ㄇㄗㄗ(ㄓㄕㄅ)
藍色眼睛=ㄌㄙㄧㄐ
想要跟你飛=ㄒㄧㄍㄋㄈ
癡情無路用=ㄔㄑㄨㄌㄩ
你真好=ㄋㄓㄏ
異鄉=ㄧㄒ
和天一樣高=ㄏㄊㄧㄧㄍ
非人物種=ㄈㄖㄨㄓ
鍾愛一生=ㄓㄞㄧㄕ
停格(純伴奏)=ㄊㄍ(ㄔㄅㄗ)
肖戰,王一博=ㄒㄓ,ㄨㄧㄅ
兩難=ㄌㄋ
娘子=ㄋㄗ
你的答案=ㄋㄉㄉㄢ
風=ㄈ
傷心酒店(純伴奏)=ㄕㄒㄐㄉ(ㄔㄅㄗ)
最近(純伴奏)=ㄗㄐ(ㄔㄅㄗ)
黑髮尤物=ㄏㄈㄧㄨ
最後今晚=ㄗㄏㄐㄨ
該忘的日子=ㄍㄨㄉㄖㄗ
還記得嗎=ㄏㄐㄉㄇ
似曾相識=ㄙㄘㄒㄕ
愛我三分鐘=ㄞㄨㄙㄈㄓ
大人的世界=ㄉㄖㄉㄕㄐ
擎歌(純伴奏)=ㄑㄍ(ㄔㄅㄗ)
一口飯=ㄧㄎㄈ
超越無限=ㄔㄩㄨㄒ
我沒有騙你=ㄨㄇㄧㄆㄋ
孫燕姿=ㄙㄧㄗ
丁噹,陳信宏=ㄉㄉ,ㄔㄒㄏ
趙露思=ㄓㄌㄙ
分享=ㄈㄒ
再回首=ㄗㄏㄕ
帶我回家=ㄉㄨㄏㄐ
漂流浴室=ㄆㄌㄩㄕ
認真就輸了=ㄖㄓㄐㄕㄌ
我沒有走開=ㄨㄇㄧㄗㄎ
夠了=ㄍㄌ
兜圈(純伴奏)=ㄉㄑ(ㄔㄅㄗ)
獎狀=ㄐㄓ
可愛的馬(純伴奏)=ㄎㄞㄉㄇ(ㄔㄅㄗ)
波爺=ㄆㄧ
木偶人=ㄇㄡㄖ
黃品源=ㄏㄆㄩ
天天晴朗=ㄊㄊㄑㄌ
心醉心碎=ㄒㄗㄒㄙ
山裡來的女孩=ㄕㄌㄌㄉㄋㄏ
金多蝦=ㄐㄉㄒ
破吉他=ㄆㄐㄊ
姊妹=ㄗㄇ
勇氣(純伴奏)=ㄩㄑ(ㄔㄅㄗ)
關老爺=ㄍㄌㄧ
月娘的眼淚(純伴奏)=ㄩㄋㄉㄧㄌ(ㄔㄅㄗ)
向蕙玲,陳隨意=ㄒㄏㄌ,ㄔㄙㄧ
佛系少女(純伴奏)=ㄈㄒㄕㄋ(ㄔㄅㄗ)
信任=ㄒㄖ
黄磊曾寶儀=ㄏㄌㄗㄅㄧ
想厝的心情=ㄒㄘㄉㄒㄑ
徐真真=ㄒㄓㄓ
雨傘代表阮心肝=ㄩㄙㄉㄅㄖㄒㄍ
未單身=ㄨㄉㄕ
失速=ㄕㄙ
什麼風把你吹來的=ㄕㄇㄈㄅㄋㄔㄌㄉ
追殺邱比特=ㄓㄕㄑㄅㄊ
黄淑惠=ㄏㄕㄏ
兩個人的同學會=ㄌㄍㄖㄉㄊㄒㄏ
姚黛瑋=ㄧㄉㄨ
爸比=ㄅㄅ
王宏恩=ㄨㄏㄣ
張少林=ㄓㄕㄌ
一秒時光=ㄧㄇㄕㄍ
陳嘉樺張軒睿=ㄔㄐㄏㄓㄒㄖ
范逸臣=ㄈㄧㄔ
廣島之戀=ㄍㄉㄓㄌ
燒肉粽(純伴奏)=ㄕㄖㄗ(ㄔㄅㄗ)
沒有第三者的分手(純伴奏)=ㄇㄧㄉㄙㄓㄉㄈㄕ(ㄔㄅㄗ)
愛不單行(純伴奏)=ㄞㄅㄉㄒ(ㄔㄅㄗ)
許莉潔安懂=ㄒㄌㄐㄢㄉ
不愛我就拉倒=ㄅㄞㄨㄐㄌㄉ
加油歌=ㄐㄧㄍ
實況轉播=ㄕㄎㄓㄅ
趁我還會記=ㄔㄨㄏㄏㄐ
江水向東流=ㄐㄕㄒㄉㄌ
綿綿舊情=ㄇㄇㄐㄑ
其實我一直都想對你說=ㄑㄕㄨㄧㄓㄉㄒㄉㄋㄕ
避難所=ㄅㄋㄙ
北京天使合唱團=ㄅㄐㄊㄕㄏㄔㄊ
頭擺的妳=ㄊㄅㄉㄋ
歡顏=ㄏㄧ
七里香=ㄑㄌㄒ
我把我的青春給你(純伴奏)=ㄨㄅㄨㄉㄑㄔㄍㄋ(ㄔㄅㄗ)
不醉不會(純伴奏)=ㄅㄗㄅㄏ(ㄔㄅㄗ)
求充滿這地=ㄑㄔㄇㄓㄉ
默=ㄇ
踏浪=ㄊㄌ
唐飛=ㄊㄈ
默契=ㄇㄑ
明天，你好(純伴奏)=ㄇㄊ，ㄋㄏ(ㄔㄅㄗ)
上愛唱的歌=ㄕㄞㄔㄉㄍ
壞壞惹人愛=ㄏㄏㄖㄖㄞ
念親恩(純伴奏)=ㄋㄑㄣ(ㄔㄅㄗ)
不顧一切的愛=ㄅㄍㄧㄑㄉㄞ
白色風車=ㄅㄙㄈㄔ
走過=ㄗㄍ
當我身旁有你在=ㄉㄨㄕㄆㄧㄋㄗ
醉李白=ㄗㄌㄅ
采子,黃偉晉=ㄘㄗ,ㄏㄨㄐ
愛情旅程=ㄞㄑㄌㄔ
女孩妳知道嗎=ㄋㄏㄋㄓㄉㄇ
穀雨=ㄍㄩ
邰正宵=ㄊㄓㄒ
愛上你等於愛上寂寞=ㄞㄕㄋㄉㄩㄞㄕㄐㄇ
惦記這一些=ㄉㄐㄓㄧㄒ
火車=ㄏㄔ
愛無畏=ㄞㄨㄨ
派對動物(純伴奏)=ㄆㄉㄉㄨ(ㄔㄅㄗ)
背叛情歌(純伴奏)=ㄅㄆㄑㄍ(ㄔㄅㄗ)
愛你愛到心痛(純伴奏)=ㄞㄋㄞㄉㄒㄊ(ㄔㄅㄗ)
月光地毯=ㄩㄍㄉㄊ
東城衛=ㄉㄔㄨ
在沒有你以後=ㄗㄇㄧㄋㄧㄏ
未完的承諾=ㄨㄨㄉㄔㄋ
因為愛情=ㄧㄨㄞㄑ
不公平(純伴奏)=ㄅㄍㄆ(ㄔㄅㄗ)
傷痕=ㄕㄏ
只是太愛你=ㄓㄕㄊㄞㄋ
黃西田=ㄏㄒㄊ
認真的人最快樂=ㄖㄓㄉㄖㄗㄎㄌ
克卜勒=ㄎㄅㄌ
不通將阮放=ㄅㄊㄐㄖㄈ
六等星の夜=ㄌㄉㄒのㄧ
不該用情=ㄅㄍㄩㄑ
手紙=ㄕㄓ
框不住的愛=ㄎㄅㄓㄉㄞ
敲敲=ㄑㄑ
懂事=ㄉㄕ
愛你愛到死=ㄞㄋㄞㄉㄙ
伴=ㄅ
王中平=ㄨㄓㄆ
找自己=ㄓㄗㄐ
很美味=ㄏㄇㄨ
深深愛過=ㄕㄕㄞㄍ
迷失幻境(純伴奏)=ㄇㄕㄏㄐ(ㄔㄅㄗ)
銀霞=ㄧㄒ
說說話(純伴奏)=ㄕㄕㄏ(ㄔㄅㄗ)
思念無罪=ㄙㄋㄨㄗ
自愛自受=ㄗㄞㄗㄕ
第二次分手=ㄉㄦㄘㄈㄕ
爸爸=ㄅㄅ
喜歡你=ㄒㄏㄋ
我難過(純伴奏)=ㄨㄋㄍ(ㄔㄅㄗ)
慢慢喜歡你=ㄇㄇㄒㄏㄋ
野生動物=ㄧㄕㄉㄨ
月亮惹的禍=ㄩㄌㄖㄉㄏ
創造營=ㄔㄗㄧ
非日常狂歡=ㄈㄖㄔㄎㄏ
後來的我們(純伴奏)=ㄏㄌㄉㄨㄇ(ㄔㄅㄗ)
藝界人生=ㄧㄐㄖㄕ
今夜的夢=ㄐㄧㄉㄇ
有種=ㄧㄓ
最初的夢想=ㄗㄔㄉㄇㄒ
朋友情=ㄆㄧㄑ
多想將一切做得完美=ㄉㄒㄐㄧㄑㄗㄉㄨㄇ
感動=ㄍㄉ
膽小鬼=ㄉㄒㄍ
如果我是你(純伴奏)=ㄖㄍㄨㄕㄋ(ㄔㄅㄗ)
你會不會=ㄋㄏㄅㄏ
練舞功=ㄌㄨㄍ
左左右右=ㄗㄗㄧㄧ
醉清風=ㄗㄑㄈ
傷心的人更傷心(純伴奏)=ㄕㄒㄉㄖㄍㄕㄒ(ㄔㄅㄗ)
旺福=ㄨㄈ
失戀陣線聯盟(純伴奏)=ㄕㄌㄓㄒㄌㄇ(ㄔㄅㄗ)
半句再見(純伴奏)=ㄅㄐㄗㄐ(ㄔㄅㄗ)
張惠妹=ㄓㄏㄇ
東方女孩=ㄉㄈㄋㄏ
回頭看看我=ㄏㄊㄎㄎㄨ
睡皇后=ㄕㄏㄏ
內疚=ㄋㄐ
春風吻上我的臉=ㄔㄈㄨㄕㄨㄉㄌ
我知道=ㄨㄓㄉ
其實你並沒那麼孤單=ㄑㄕㄋㄅㄇㄋㄇㄍㄉ
小白=ㄒㄅ
分手後不要做朋友=ㄈㄕㄏㄅㄧㄗㄆㄧ
謝謝你的愛(粵語)=ㄒㄒㄋㄉㄞ(ㄩㄩ)
明明白白我的心=ㄇㄇㄅㄅㄨㄉㄒ
劉家昌,尤雅=ㄌㄐㄔ,ㄧㄧ
我的驕傲=ㄨㄉㄐㄠ
忘情忘愛=ㄨㄑㄨㄞ
安妮之島=ㄢㄋㄓㄉ
中森明菜=ㄓㄙㄇㄘ
王牌冤家=ㄨㄆㄩㄐ
愛情批=ㄞㄑㄆ
五天四夜=ㄨㄊㄙㄧ
拜請保生大帝=ㄅㄑㄅㄕㄉㄉ
小春,=ㄒㄔ,
絕=ㄐ
擁抱世界擁抱你=ㄩㄅㄕㄐㄩㄅㄋ
不知所措=ㄅㄓㄙㄘ
周治平=ㄓㄓㄆ
平凡的一天=ㄆㄈㄉㄧㄊ
分手快樂=ㄈㄕㄎㄌ
七百年後=ㄑㄅㄋㄏ
哎呀=ㄞㄧ
靜悄悄=ㄐㄑㄑ
你能聽見嗎=ㄋㄋㄊㄐㄇ
加州陽光=ㄐㄓㄧㄍ
張碧珠=ㄓㄅㄓ
想見你想見你想見你=ㄒㄐㄋㄒㄐㄋㄒㄐㄋ
鄭伊健=ㄓㄧㄐ
憂愁的牡丹=ㄧㄔㄉㄇㄉ
陽光美眉=ㄧㄍㄇㄇ
不搭=ㄅㄉ
嫁=ㄐ
不哭(純伴奏)=ㄅㄎ(ㄔㄅㄗ)
最愛的人傷我最深=ㄗㄞㄉㄖㄕㄨㄗㄕ
我在人民廣場吃炸雞=ㄨㄗㄖㄇㄍㄔㄔㄓㄐ
真的=ㄓㄉ
國境之南=ㄍㄐㄓㄋ
劉平芳=ㄌㄆㄈ
戀人無雙=ㄌㄖㄨㄕ
放捨你我心嘸甘(純伴奏)=ㄈㄕㄋㄨㄒㄈㄍ(ㄔㄅㄗ)
眼底星空=ㄧㄉㄒㄎ
單身≠失戀=ㄉㄕ≠ㄕㄌ
你太猖狂=ㄋㄊㄔㄎ
張杰=ㄓㄐ
不要不要的=ㄅㄧㄅㄧㄉ
天天=ㄊㄊ
查某囡仔(純伴奏)=ㄔㄇㄋㄗ(ㄔㄅㄗ)
蔡旻佑=ㄘㄇㄧ
九百九十九朵玫瑰=ㄐㄅㄐㄕㄐㄉㄇㄍ
她愛了我好久(純伴奏)=ㄊㄞㄌㄨㄏㄐ(ㄔㄅㄗ)
大阪小雨=ㄉㄅㄒㄩ
鄭秀文=ㄓㄒㄨ
練習(純伴奏)=ㄌㄒ(ㄔㄅㄗ)
再會啦心愛的無緣的人=ㄗㄏㄌㄒㄞㄉㄨㄩㄉㄖ
壁咚=ㄅㄉ
昴=ㄇ
冷冷的心上人=ㄌㄌㄉㄒㄕㄖ
幸福的臉(純伴奏)=ㄒㄈㄉㄌ(ㄔㄅㄗ)
不一樣了=ㄅㄧㄧㄌ
楊坤,蕭薔=ㄧㄎ,ㄒㄑ
我可以抱你嗎=ㄨㄎㄧㄅㄋㄇ
微光=ㄨㄍ
星光=ㄒㄍ
笑納(純伴奏)=ㄒㄋ(ㄔㄅㄗ)
平井堅=ㄆㄐㄐ
是否我真的一無所有=ㄕㄈㄨㄓㄉㄧㄨㄙㄧ
單薄的愛=ㄉㄅㄉㄞ
無情的雨無情的你=ㄨㄑㄉㄩㄨㄑㄉㄋ
南拳媽媽=ㄋㄑㄇㄇ
一天天一點點=ㄧㄊㄊㄧㄉㄉ
怎麼了=ㄗㄇㄌ
不要不要=ㄅㄧㄅㄧ
你不會了解=ㄋㄅㄏㄌㄐ
愛一直閃亮=ㄞㄧㄓㄕㄌ
曲盡陳情=ㄑㄐㄔㄑ
相遇太早=ㄒㄩㄊㄗ
想你最後一天=ㄒㄋㄗㄏㄧㄊ
什麼什麼=ㄕㄇㄕㄇ
江山美人(純伴奏)=ㄐㄕㄇㄖ(ㄔㄅㄗ)
若沒愛你要愛誰=ㄖㄇㄞㄋㄧㄞㄕ
好好愛我(純伴奏)=ㄏㄏㄞㄨ(ㄔㄅㄗ)
用心良苦(純伴奏)=ㄩㄒㄌㄎ(ㄔㄅㄗ)
小魂=ㄒㄏ
天使忌妒的生活=ㄊㄕㄐㄉㄉㄕㄏ
再見我的愛人=ㄗㄐㄨㄉㄞㄖ
醉相思(純伴奏)=ㄗㄒㄙ(ㄔㄅㄗ)
十年一刻(純伴奏)=ㄕㄋㄧㄎ(ㄔㄅㄗ)
最後的夜=ㄗㄏㄉㄧ
忠宇=ㄓㄩ
楊培安=ㄧㄆㄢ
黃詩扶=ㄏㄕㄈ
浪流連(純伴奏)=ㄌㄌㄌ(ㄔㄅㄗ)
傻孩子=ㄕㄏㄗ
像風一樣=ㄒㄈㄧㄧ
黃明志=ㄏㄇㄓ
心中無別人=ㄒㄓㄨㄅㄖ
心愛的女王=ㄒㄞㄉㄋㄨ
閃亮三姊妹=ㄕㄌㄙㄗㄇ
歸人．沙城=ㄍㄖ．ㄕㄔ
陳美鳳,伍浩哲=ㄔㄇㄈ,ㄨㄏㄓ
一千零一個願望=ㄧㄑㄌㄧㄍㄩㄨ
離場=ㄌㄔ
星=ㄒ
誠實地想你=ㄔㄕㄉㄒㄋ
陳勢安=ㄔㄕㄢ
想你一整夜=ㄒㄋㄧㄓㄧ
猶原在夢中=ㄧㄩㄗㄇㄓ
幸福的等待=ㄒㄈㄉㄉㄉ
蘇慧倫,莫文蔚=ㄙㄏㄌ,ㄇㄨㄨ
你那好冷的小手=ㄋㄋㄏㄌㄉㄒㄕ
墓仔埔也敢去(純伴奏)=ㄇㄗㄆㄧㄍㄑ(ㄔㄅㄗ)
將妳留=ㄐㄋㄌ
你是我所有的回憶=ㄋㄕㄨㄙㄧㄉㄏㄧ
都什麼時候了=ㄉㄕㄇㄕㄏㄌ
回眸=ㄏㄇ
劉文正=ㄌㄨㄓ
其實我(純伴奏)=ㄑㄕㄨ(ㄔㄅㄗ)
月牙灣(純伴奏)=ㄩㄧㄨ(ㄔㄅㄗ)
交通大學級=ㄐㄊㄉㄒㄐ
鄉下來的=ㄒㄒㄌㄉ
一磚一瓦(純伴奏)=ㄧㄓㄧㄨ(ㄔㄅㄗ)
不難=ㄅㄋ
會哭的人不一定流淚=ㄏㄎㄉㄖㄅㄧㄉㄌㄌ
星夜的離別(純伴奏)=ㄒㄧㄉㄌㄅ(ㄔㄅㄗ)
我的歌聲裡=ㄨㄉㄍㄕㄌ
理想混蛋=ㄌㄒㄏㄉ
愛瘋=ㄞㄈ
陳勢安黃啟銘曾國琿賴力豪宇田=ㄔㄕㄢㄏㄑㄇㄘㄍㄏㄌㄌㄏㄩㄊ
鄧紫棋,周興哲=ㄉㄗㄑ,ㄓㄒㄓ
來歡呼跳戰舞=ㄌㄏㄏㄊㄓㄨ
簾後=ㄌㄏ
雙城故事=ㄕㄔㄍㄕ
博杯=ㄅㄅ
鬥牛舞=ㄉㄋㄨ
我=ㄨ
世界這麼大還是遇見你=ㄕㄐㄓㄇㄉㄏㄕㄩㄐㄋ
這叫愛=ㄓㄐㄞ
一千個傷心的理由(純伴奏)=ㄧㄑㄍㄕㄒㄉㄌㄧ(ㄔㄅㄗ)
再回首(純伴奏)=ㄗㄏㄕ(ㄔㄅㄗ)
淡水八景活動=ㄉㄕㄅㄐㄏㄉ
不懂=ㄅㄉ
放阮一個人=ㄈㄖㄧㄍㄖ
凝望=ㄋㄨ
情何以堪=ㄑㄏㄧㄎ
我們都是這樣長大的=ㄨㄇㄉㄕㄓㄧㄓㄉㄉ
田馥甄,井柏然=ㄊㄈㄓ,ㄐㄅㄖ
送給你=ㄙㄍㄋ
讓愛飛起來=ㄖㄞㄈㄑㄌ
林俊吉=ㄌㄐㄐ
戀愛症候群=ㄌㄞㄓㄏㄑ
藉口=ㄐㄎ
食物鏈=ㄕㄨㄌ
煙幕=ㄧㄇ
發福發財中國年=ㄈㄈㄈㄘㄓㄍㄋ
愷樂,呂國緯,羅志祥=ㄎㄌ,ㄌㄍㄨ,ㄌㄓㄒ
不浪漫罪名(純伴奏)=ㄅㄌㄇㄗㄇ(ㄔㄅㄗ)
這就是愛嗎=ㄓㄐㄕㄞㄇ
其實幸福很簡單=ㄑㄕㄒㄈㄏㄐㄉ
萬芳=ㄨㄈ
搖籃曲=ㄧㄌㄑ
嗨早安用早餐=ㄏㄗㄢㄩㄗㄘ
林玉英=ㄌㄩㄧ
冷冷的心上人(純伴奏)=ㄌㄌㄉㄒㄕㄖ(ㄔㄅㄗ)
火鍋底料=ㄏㄍㄉㄌ
你看不見的地方=ㄋㄎㄅㄐㄉㄉㄈ
那天=ㄋㄊ
幸福就好=ㄒㄈㄐㄏ
一時倦了=ㄧㄕㄐㄌ
千里之外(純伴奏)=ㄑㄌㄓㄨ(ㄔㄅㄗ)
我們的歌=ㄨㄇㄉㄍ
花千樹(純伴奏)=ㄏㄑㄕ(ㄔㄅㄗ)
雨衣=ㄩㄧ
看我變=ㄎㄨㄅ
游士衢=ㄧㄕㄑ
水星記(純伴奏)=ㄕㄒㄐ(ㄔㄅㄗ)
相思過頭=ㄒㄙㄍㄊ
意外=ㄧㄨ
惡作劇=ㄜㄗㄐ
孤獨是會上癮的=ㄍㄉㄕㄏㄕㄧㄉ
三年二班=ㄙㄋㄦㄅ
周杰倫=ㄓㄐㄌ
心如刀割=ㄒㄖㄉㄍ
朋友=ㄆㄧ
今生只為你=ㄐㄕㄓㄨㄋ
水摻沙=ㄕㄔㄕ
傷心的街巷=ㄕㄒㄉㄐㄒ
最美的太陽=ㄗㄇㄉㄊㄧ
平凡=ㄆㄈ
滴答滴=ㄉㄉㄉ
好可惜=ㄏㄎㄒ
燒酒斟雙杯(純伴奏)=ㄕㄐㄓㄕㄅ(ㄔㄅㄗ)
寂寞更生=ㄐㄇㄍㄕ
兩個人=ㄌㄍㄖ
口袋的溫度=ㄎㄉㄉㄨㄉ
滑翔翼=ㄏㄒㄧ
捉泥鳅=ㄓㄋㄑ
春夏秋冬=ㄔㄒㄑㄉ
熱狗=ㄖㄍ
壞人=ㄏㄖ
還好=ㄏㄏ
讓世界毀滅=ㄖㄕㄐㄏㄇ
驚嘆號=ㄐㄊㄏ
李香蘭=ㄌㄒㄌ
不在乎他(純伴奏)=ㄅㄗㄏㄊ(ㄔㄅㄗ)
王凱=ㄨㄎ
勇敢的男兒=ㄩㄍㄉㄋㄦ
潘小璇,賴思穎,盧修琪=ㄆㄒㄒ,ㄌㄙㄧ,ㄌㄒㄑ
劉惜君=ㄌㄒㄐ
那就這樣吧=ㄋㄐㄓㄧㄅ
妙妙妙=ㄇㄇㄇ
蹦趴=ㄅㄆ
真正的自由是=ㄓㄓㄉㄗㄧㄕ
一翦梅(純伴奏)=ㄧㄐㄇ(ㄔㄅㄗ)
粉雪=ㄈㄒ
問月娘(純伴奏)=ㄨㄩㄋ(ㄔㄅㄗ)
阿蘭=ㄚㄌ
結髮一輩子=ㄐㄈㄧㄅㄗ
黑天鵝=ㄏㄊㄜ
李恕權=ㄌㄕㄑ
只有一個你=ㄓㄧㄧㄍㄋ
與妳到永久=ㄩㄋㄉㄩㄐ
屁孩,卍老濕=ㄆㄏ,ㄨㄌㄕ
心肝仔囝=ㄒㄍㄗㄋ
世界上沒有真正的感同身受=ㄕㄐㄕㄇㄧㄓㄓㄉㄍㄊㄕㄕ
林姍=ㄌㄒ
楓林小橋=ㄈㄌㄒㄑ
香香=ㄒㄒ
張雨生,姚可傑,邰正宵,王傑,星星月亮太陽=ㄓㄩㄕ,ㄧㄎㄐ,ㄊㄓㄒ,ㄨㄐ,ㄒㄒㄩㄌㄊㄧ
堆積情感=ㄉㄐㄑㄍ
青青黃黃的=ㄑㄑㄏㄏㄉ
方泂鑌=ㄈㄐㄅ
小小湯陳之漢大隸=ㄒㄒㄊㄔㄓㄏㄉㄌ
回家的路=ㄏㄐㄉㄌ
愛太空(純伴奏)=ㄞㄊㄎ(ㄔㄅㄗ)
李竺芯=ㄌㄓㄒ
腹語術=ㄈㄩㄕ
意難平=ㄧㄋㄆ
還是想念=ㄏㄕㄒㄋ
四分衛=ㄙㄈㄨ
泡沫(純伴奏)=ㄆㄇ(ㄔㄅㄗ)
美麗的交換=ㄇㄌㄉㄐㄏ
捨不得你走=ㄕㄅㄉㄋㄗ
新少女祈禱=ㄒㄕㄋㄑㄉ
你的重要(純伴奏)=ㄋㄉㄓㄧ(ㄔㄅㄗ)
茄子蛋=ㄑㄗㄉ
遙遠的牽掛=ㄧㄩㄉㄑㄍ
任逍遙=ㄖㄒㄧ
紅人館=ㄏㄖㄍ
一輩子一場夢=ㄧㄅㄗㄧㄔㄇ
江蕙,熊天益=ㄐㄏ,ㄒㄊㄧ
非你莫屬=ㄈㄋㄇㄕ
蔡麗津王中平=ㄘㄌㄐㄨㄓㄆ
張燕清=ㄓㄧㄑ
台風少年團=ㄊㄈㄕㄋㄊ
忘記時間(純伴奏)=ㄨㄐㄕㄐ(ㄔㄅㄗ)
財神到=ㄘㄕㄉ
潘瑋柏,弦子=ㄆㄨㄅ,ㄒㄗ
想你呀=ㄒㄋㄧ
關正傑=ㄍㄓㄐ
天涯同心肝=ㄊㄧㄊㄒㄍ
再相會=ㄗㄒㄏ
愛笑的眼睛=ㄞㄒㄉㄧㄐ
對你懷念特別多=ㄉㄋㄏㄋㄊㄅㄉ
江音=ㄐㄧ
一點點光=ㄧㄉㄉㄍ
愛是個什麼東西=ㄞㄕㄍㄕㄇㄉㄒ
記得=ㄐㄉ
放一顆心=ㄈㄧㄎㄒ
笑著回家=ㄒㄓㄏㄐ
迎春花=ㄧㄔㄏ
寂寞保龄球=ㄐㄇㄅㄌㄑ
女神=ㄋㄕ
金智娟=ㄐㄓㄐ
等我回來=ㄉㄨㄏㄌ
思慕的人=ㄙㄇㄉㄖ
嫁給我=ㄐㄍㄨ
一生託給一個人=ㄧㄕㄊㄍㄧㄍㄖ
達爾文=ㄉㄦㄨ
芝麻龍眼=ㄓㄇㄌㄧ
偈=ㄐ
堅持愛到底=ㄐㄔㄞㄉㄉ
許願池=ㄒㄩㄔ
勢在必行(純伴奏)=ㄕㄗㄅㄒ(ㄔㄅㄗ)
川島茉樹代=ㄔㄉㄇㄕㄉ
體貼=ㄊㄊ
微涼的你=ㄨㄌㄉㄋ
聽袁惟仁彈吉他=ㄊㄩㄨㄖㄊㄐㄊ
探戈跳抹煞=ㄊㄍㄊㄇㄕ
好想對你說=ㄏㄒㄉㄋㄕ
街頭霸王=ㄐㄊㄅㄨ
病人=ㄅㄖ
陪我看日出=ㄆㄨㄎㄖㄔ
柯受良=ㄎㄕㄌ
我很快樂=ㄨㄏㄎㄌ
余昭源葉里=ㄩㄓㄩㄧㄌ
你不是真正的快樂(純伴奏)=ㄋㄅㄕㄓㄓㄉㄎㄌ(ㄔㄅㄗ)
達拉崩吧=ㄉㄌㄅㄅ
緊行緊遠=ㄐㄒㄐㄩ
熱舞恰恰=ㄖㄨㄑㄑ
猴籠(純伴奏)=ㄏㄌ(ㄔㄅㄗ)
耳朵要解渴=ㄦㄉㄧㄐㄎ
良人(純伴奏)=ㄌㄖ(ㄔㄅㄗ)
心情歌路=ㄒㄑㄍㄌ
缺氧=ㄑㄧ
尹詩涵=ㄧㄕㄏ
求佛=ㄑㄈ
無限大=ㄨㄒㄉ
我愛妳=ㄨㄞㄋ
衝口而出=ㄔㄎㄦㄔ
謝金燕=ㄒㄐㄧ
張國榮=ㄓㄍㄖ
我要飛=ㄨㄧㄈ
阿爸的虱目魚=ㄚㄅㄉㄕㄇㄩ
外面的世界=ㄨㄇㄉㄕㄐ
永遠不再=ㄩㄩㄅㄗ
媽媽我想你(純伴奏)=ㄇㄇㄨㄒㄋ(ㄔㄅㄗ)
美麗心情=ㄇㄌㄒㄑ
看上她(純伴奏)=ㄎㄕㄊ(ㄔㄅㄗ)
強求=ㄑㄑ
寧夏=ㄋㄒ
扛得住(純伴奏)=ㄎㄉㄓ(ㄔㄅㄗ)
戀愛達人(純伴奏)=ㄌㄞㄉㄖ(ㄔㄅㄗ)
鴛鴦情=ㄩㄧㄑ
可惜我是水瓶座=ㄎㄒㄨㄕㄕㄆㄗ
超跑情人夢=ㄔㄆㄑㄖㄇ
缺口聲學=ㄑㄎㄕㄒ
媽媽請你不通痛=ㄇㄇㄑㄋㄅㄊㄊ
重度寂寞=ㄓㄉㄐㄇ
雨傘情=ㄩㄙㄑ
愛是你我=ㄞㄕㄋㄨ
天頂星=ㄊㄉㄒ
陽光的陪伴=ㄧㄍㄉㄆㄅ
今夜跳倫巴=ㄐㄧㄊㄌㄅ
單細胞=ㄉㄒㄅ
我沒有傷心=ㄨㄇㄧㄕㄒ
無底洞=ㄨㄉㄉ
幾度夕陽紅(純伴奏)=ㄐㄉㄒㄧㄏ(ㄔㄅㄗ)
大泫=ㄉㄒ
海海人生=ㄏㄏㄖㄕ
手寫的從前=ㄕㄒㄉㄘㄑ
任賢齊,江蕙=ㄖㄒㄑ,ㄐㄏ
蕭玉芬=ㄒㄩㄈ
可惜沒如果(純伴奏)=ㄎㄒㄇㄖㄍ(ㄔㄅㄗ)
不是我不小心=ㄅㄕㄨㄅㄒㄒ
證據=ㄓㄐ
候鳥=ㄏㄋ
今夜雨濛濛=ㄐㄧㄩㄇㄇ
風起時=ㄈㄑㄕ
戰神=ㄓㄕ
匆忙人生=ㄘㄇㄖㄕ
嚴藝丹=ㄧㄧㄉ
故鄉的風=ㄍㄒㄉㄈ
甲天借時間=ㄐㄊㄐㄕㄐ
陳隨意,唐儷=ㄔㄙㄧ,ㄊㄌ
要發達=ㄧㄈㄉ
陳忻玥=ㄔㄒㄩ
望月想愛人=ㄨㄩㄒㄞㄖ
那女孩對我說(純伴奏)=ㄋㄋㄏㄉㄨㄕ(ㄔㄅㄗ)
慢慢喜歡你(純伴奏)=ㄇㄇㄒㄏㄋ(ㄔㄅㄗ)
石磨的心=ㄕㄇㄉㄒ
斷了=ㄉㄌ
美人魚=ㄇㄖㄩ
舉棋不定=ㄐㄑㄅㄉ
似是故人來=ㄙㄕㄍㄖㄌ
幸福的瞬間=ㄒㄈㄉㄕㄐ
煎熬(純伴奏)=ㄐㄠ(ㄔㄅㄗ)
韓庚=ㄏㄍ
自由=ㄗㄧ
忘不掉的傷(純伴奏)=ㄨㄅㄉㄉㄕ(ㄔㄅㄗ)
恭喜發財=ㄍㄒㄈㄘ
曲祐良=ㄑㄧㄌ
心裡面=ㄒㄌㄇ
聽風的歌=ㄊㄈㄉㄍ
心愛的別走=ㄒㄞㄉㄅㄗ
有影無=ㄧㄧㄨ
想=ㄒ
樹藤=ㄕㄊ
思念你的心肝你敢知(純伴奏)=ㄙㄋㄋㄉㄒㄍㄋㄍㄓ(ㄔㄅㄗ)
近在眼前=ㄐㄗㄧㄑ
我要謝謝你=ㄨㄧㄒㄒㄋ
不能承受的感動=ㄅㄋㄔㄕㄉㄍㄉ
你是我的眼=ㄋㄕㄨㄉㄧ
方炯鑌=ㄈㄐㄅ
綠繡眼=ㄌㄒㄧ
慢冷=ㄇㄌ
心愛的人=ㄒㄞㄉㄖ
黃若熙=ㄏㄖㄒ
憨人(純伴奏)=ㄏㄖ(ㄔㄅㄗ)
想你的彼條歌=ㄒㄋㄉㄅㄊㄍ
愛的可能=ㄞㄉㄎㄋ
彭羚=ㄆㄌ
香草把噗=ㄒㄘㄅㄆ
痴情月娘島=ㄔㄑㄩㄋㄉ
迷魂香=ㄇㄏㄒ
忘了怎麼快樂(純伴奏)=ㄨㄌㄗㄇㄎㄌ(ㄔㄅㄗ)
娜奴娃情歌(純伴奏)=ㄋㄋㄨㄑㄍ(ㄔㄅㄗ)
穿越=ㄔㄩ
江清蓉=ㄐㄑㄖ
思念=ㄙㄋ
我的未來式=ㄨㄉㄨㄌㄕ
北風和太陽=ㄅㄈㄏㄊㄧ
蔡維澤,楊芸晴=ㄘㄨㄗ,ㄧㄩㄑ
可憐的人=ㄎㄌㄉㄖ
勇敢一次=ㄩㄍㄧㄘ
我選擇笑=ㄨㄒㄗㄒ
口香糖=ㄎㄒㄊ
小孩=ㄒㄏ
運氣來得若有似無(純伴奏)=ㄩㄑㄌㄉㄖㄧㄙㄨ(ㄔㄅㄗ)
蘇打綠,張韶涵=ㄙㄉㄌ,ㄓㄕㄏ
你快樂未必我快樂=ㄋㄎㄌㄨㄅㄨㄎㄌ
愛的主打歌=ㄞㄉㄓㄉㄍ
舞月光=ㄨㄩㄍ
美麗舊世界(純伴奏)=ㄇㄌㄐㄕㄐ(ㄔㄅㄗ)
因為有祢=ㄧㄨㄧㄋ
紅塵客棧=ㄏㄔㄎㄓ
我天天醉=ㄨㄊㄊㄗ
跳進來=ㄊㄐㄌ
吻我吧=ㄨㄨㄅ
陳亞蘭施文彬=ㄔㄧㄌㄕㄨㄅ
羅志祥,蕭亞軒=ㄌㄓㄒ,ㄒㄧㄒ
陽光的陪伴(純伴奏)=ㄧㄍㄉㄆㄅ(ㄔㄅㄗ)
你讓我懂=ㄋㄖㄨㄉ
玉蝴蝶=ㄩㄏㄉ
大山為我挪開(純伴奏)=ㄉㄕㄨㄨㄋㄎ(ㄔㄅㄗ)
路邊的野花不要採(純伴奏)=ㄌㄅㄉㄧㄏㄅㄧㄘ(ㄔㄅㄗ)
麥霸=ㄇㄅ
麗娜=ㄌㄋ
黃霄雲=ㄏㄒㄩ
我要錢=ㄨㄧㄑ
七彩的微風=ㄑㄘㄉㄨㄈ
愛到無命不知驚=ㄞㄉㄨㄇㄅㄓㄐ
陳小雲=ㄔㄒㄩ
飄零的落花=ㄆㄌㄉㄌㄏ
曹楊=ㄘㄧ
陳淑樺,李宗盛=ㄔㄕㄏ,ㄌㄗㄕ
野獸(純伴奏)=ㄧㄕ(ㄔㄅㄗ)
女人們的咖啡=ㄋㄖㄇㄉㄎㄈ
我們=ㄨㄇ
冬戀(純伴奏)=ㄉㄌ(ㄔㄅㄗ)
江玲=ㄐㄌ
等一個人=ㄉㄧㄍㄖ
最長的電影=ㄗㄔㄉㄉㄧ
巫啟賢=ㄨㄑㄒ
小半=ㄒㄅ
酒店關門之後=ㄐㄉㄍㄇㄓㄏ
千百惠=ㄑㄅㄏ
我高舉雙手=ㄨㄍㄐㄕㄕ
不忘(純伴奏)=ㄅㄨ(ㄔㄅㄗ)
城門城門雞蛋糕=ㄔㄇㄔㄇㄐㄉㄍ
一百種失戀的方法=ㄧㄅㄓㄕㄌㄉㄈㄈ
我又想你了=ㄨㄧㄒㄋㄌ
望你疼惜=ㄨㄋㄊㄒ
最後一首情歌=ㄗㄏㄧㄕㄑㄍ
當愛已成往事(純伴奏)=ㄉㄞㄧㄔㄨㄕ(ㄔㄅㄗ)
小潘潘,小峰峰=ㄒㄆㄆ,ㄒㄈㄈ
王貳浪=ㄨㄦㄌ
亦敵亦友=ㄧㄉㄧㄧ
舊情綿綿=ㄐㄑㄇㄇ
半生熟=ㄅㄕㄕ
又不是這樣就不孤獨(純伴奏)=ㄧㄅㄕㄓㄧㄐㄅㄍㄉ(ㄔㄅㄗ)
一暝=ㄧㄇ
至少我還記得=ㄓㄕㄨㄏㄐㄉ
刀劍如夢=ㄉㄐㄖㄇ
高進,小沈陽=ㄍㄐ,ㄒㄔㄧ
陌路=ㄇㄌ
無價至寶=ㄨㄐㄓㄅ
難得有情人=ㄋㄉㄧㄑㄖ
王強=ㄨㄑ
妥協=ㄊㄒ
一定贏=ㄧㄉㄧ
許佳慧=ㄒㄐㄏ
手印=ㄕㄧ
謝謝你愛我=ㄒㄒㄋㄞㄨ
回憶總想哭(純伴奏)=ㄏㄧㄗㄒㄎ(ㄔㄅㄗ)
元衛覺醒=ㄩㄨㄐㄒ
妳說他=ㄋㄕㄊ
黑色天空=ㄏㄙㄊㄎ
靜婷=ㄐㄊ
星月=ㄒㄩ
願得一人心=ㄩㄉㄧㄖㄒ
當你老了=ㄉㄋㄌㄌ
劉人語=ㄌㄖㄩ
彼得潘(純伴奏)=ㄅㄉㄆ(ㄔㄅㄗ)
多年後=ㄉㄋㄏ
填空(純伴奏)=ㄊㄎ(ㄔㄅㄗ)
愛的雙重魔力=ㄞㄉㄕㄔㄇㄌ
深秋的黎明=ㄕㄑㄉㄌㄇ
星河=ㄒㄏ
透明=ㄊㄇ
我找你找了好久=ㄨㄓㄋㄓㄌㄏㄐ
驗傷=ㄧㄕ
長崎蝴蝶姑娘=ㄔㄑㄏㄉㄍㄋ
也罷(純伴奏)=ㄧㄅ(ㄔㄅㄗ)
喝采=ㄏㄘ
我的秘密=ㄨㄉㄇㄇ
愛難求=ㄞㄋㄑ
別=ㄅ
我很好那麼你呢?=ㄨㄏㄏㄋㄇㄋㄋ?
陳思安,吳俊宏=ㄔㄙㄢ,ㄨㄐㄏ
分手的慶功=ㄈㄕㄉㄑㄍ
掌紋(純伴奏)=ㄓㄨ(ㄔㄅㄗ)
暗淡的月=ㄢㄉㄉㄩ
半醉半清醒=ㄅㄗㄅㄑㄒ
度(純伴奏)=ㄉ(ㄔㄅㄗ)
孫儷=ㄙㄌ
你不孤單=ㄋㄅㄍㄉ
甦醒=ㄙㄒ
我想你知道=ㄨㄒㄋㄓㄉ
一百萬個可能=ㄧㄅㄨㄍㄎㄋ
那個她=ㄋㄍㄊ
江蕙施文彬=ㄐㄏㄕㄨㄅ
說不出口的想念=ㄕㄅㄔㄎㄉㄒㄋ
十七=ㄕㄑ
男人的堅持=ㄋㄖㄉㄐㄔ
我是冠軍=ㄨㄕㄍㄐ
我的情書=ㄨㄉㄑㄕ
習譜予=ㄒㄆㄩ
保持微笑=ㄅㄔㄨㄒ
漂洋過海來看你=ㄆㄧㄍㄏㄌㄎㄋ
跟自己合唱=ㄍㄗㄐㄏㄔ
黑色柳丁=ㄏㄙㄌㄉ
醉赤壁(純伴奏)=ㄗㄔㄅ(ㄔㄅㄗ)
水手怕水=ㄕㄕㄆㄕ
別勉強(純伴奏)=ㄅㄇㄑ(ㄔㄅㄗ)
修煉愛情(純伴奏)=ㄒㄌㄞㄑ(ㄔㄅㄗ)
葉子=ㄧㄗ
如果愛=ㄖㄍㄞ
我們都能幸福著=ㄨㄇㄉㄋㄒㄈㄓ
愛過了頭=ㄞㄍㄌㄊ
等三年=ㄉㄙㄋ
十架上的愛=ㄕㄐㄕㄉㄞ
猜測=ㄘㄘ
有情人總被無情傷=ㄧㄑㄖㄗㄅㄨㄑㄕ
自導自演(純伴奏)=ㄗㄉㄗㄧ(ㄔㄅㄗ)
金魚花火=ㄐㄩㄏㄏ
有我在=ㄧㄨㄗ
郭鎬鳴=ㄍㄏㄇ
谷微=ㄍㄨ
剪愛=ㄐㄞ
我和我追逐的夢=ㄨㄏㄨㄓㄓㄉㄇ
菠蘿菠蘿蜜(純伴奏)=ㄅㄌㄅㄌㄇ(ㄔㄅㄗ)
日常=ㄖㄔ
我還想她=ㄨㄏㄒㄊ
風流做田人=ㄈㄌㄗㄊㄖ
歸屬=ㄍㄕ
中華民國頌(純伴奏)=ㄓㄏㄇㄍㄙ(ㄔㄅㄗ)
閃亮寶貝=ㄕㄌㄅㄅ
不讓我的眼淚陪我過夜=ㄅㄖㄨㄉㄧㄌㄆㄨㄍㄧ
史斯宇=ㄕㄙㄩ
最美不過初相見=ㄗㄇㄅㄍㄔㄒㄐ
騎你的機車去兜風=ㄑㄋㄉㄐㄔㄑㄉㄈ
身騎白馬=ㄕㄑㄅㄇ
裂心=ㄌㄒ
彼時(純伴奏)=ㄅㄕ(ㄔㄅㄗ)
青春有你=ㄑㄔㄧㄋ
塵埃(純伴奏)=ㄔㄞ(ㄔㄅㄗ)
用性命愛我=ㄩㄒㄇㄞㄨ
戀愛日記=ㄌㄞㄖㄐ
全日愛=ㄑㄖㄞ
借孤單=ㄐㄍㄉ
最後火車站=ㄗㄏㄏㄔㄓ
預言家(純伴奏)=ㄩㄧㄐ(ㄔㄅㄗ)
無窮=ㄨㄑ
天天想你(純伴奏)=ㄊㄊㄒㄋ(ㄔㄅㄗ)
我的眼流下你的淚=ㄨㄉㄧㄌㄒㄋㄉㄌ
小小的太陽=ㄒㄒㄉㄊㄧ
半夢半醒=ㄅㄇㄅㄒ
中毒=ㄓㄉ
不老的傳說=ㄅㄌㄉㄔㄕ
自行浪漫=ㄗㄒㄌㄇ
劉家昌=ㄌㄐㄔ
黃舒駿=ㄏㄕㄐ
妹妹背著洋娃娃=ㄇㄇㄅㄓㄧㄨㄨ
入戲太深=ㄖㄒㄊㄕ
我賴你=ㄨㄌㄋ
許茹芸,阿穆隆=ㄒㄖㄩ,ㄚㄇㄌ
冷血動物=ㄌㄒㄉㄨ
一路順風(純伴奏)=ㄧㄌㄕㄈ(ㄔㄅㄗ)
揮著翅膀的女孩=ㄏㄓㄔㄅㄉㄋㄏ
蕭賀碩=ㄒㄏㄕ
算什麼男人=ㄙㄕㄇㄋㄖ
原來你什麼都不要(純伴奏)=ㄩㄌㄋㄕㄇㄉㄅㄧ(ㄔㄅㄗ)
佛跳牆=ㄈㄊㄑ
炮仔聲=ㄆㄗㄕ
可愛的人方可愛=ㄎㄞㄉㄖㄈㄎㄞ
季欣霈=ㄐㄒㄆ
進退兩難=ㄐㄊㄌㄋ
寒露(純伴奏)=ㄏㄌ(ㄔㄅㄗ)
想著你的感覺=ㄒㄓㄋㄉㄍㄐ
獨上西樓=ㄉㄕㄒㄌ
飛雲之下(純伴奏)=ㄈㄩㄓㄒ(ㄔㄅㄗ)
愛神=ㄞㄕ
黃文星=ㄏㄨㄒ
做你的=ㄗㄋㄉ
受了點傷=ㄕㄌㄉㄕ
時間的滋味=ㄕㄐㄉㄗㄨ
就到這=ㄐㄉㄓ
唯舞獨尊=ㄨㄨㄉㄗ
任家萱,蕭煌奇=ㄖㄐㄒ,ㄒㄏㄑ
光的定律=ㄍㄉㄉㄌ
五輪真弓=ㄨㄌㄓㄍ
乾杯(純伴奏)=ㄍㄅ(ㄔㄅㄗ)
風起時(純伴奏)=ㄈㄑㄕ(ㄔㄅㄗ)
交代=ㄐㄉ
遇見(純伴奏)=ㄩㄐ(ㄔㄅㄗ)
今夜呼阮為你醉=ㄐㄧㄏㄖㄨㄋㄗ
極美=ㄐㄇ
星星堆滿天=ㄒㄒㄉㄇㄊ
飛向你飛向我=ㄈㄒㄋㄈㄒㄨ
我不愛=ㄨㄅㄞ
如我=ㄖㄨ
良人=ㄌㄖ
蹦蹦=ㄅㄅ
女人心事=ㄋㄖㄒㄕ
好聽=ㄏㄊ
台北孤兒=ㄊㄅㄍㄦ
遇見另一個自己=ㄩㄐㄌㄧㄍㄗㄐ
中島美嘉=ㄓㄉㄇㄐ
手心=ㄕㄒ
步戲=ㄅㄒ
完全感覚=ㄨㄑㄍ覚
誰能禁止我的愛(純伴奏)=ㄕㄋㄐㄓㄨㄉㄞ(ㄔㄅㄗ)
許容欣,陳芝緗,陳韋慈=ㄒㄖㄒ,ㄔㄓㄒ,ㄔㄨㄘ
秘密=ㄇㄇ
紅豆(純伴奏)=ㄏㄉ(ㄔㄅㄗ)
燭光晚餐=ㄓㄍㄨㄘ
我的地盤=ㄨㄉㄉㄆ
最近=ㄗㄐ
四塊五=ㄙㄎㄨ
畫心=ㄏㄒ
嚮往=ㄒㄨ
楊蕎安,同恩,夏宇童=ㄧㄑㄢ,ㄊㄣ,ㄒㄩㄊ
程響=ㄔㄒ
新娘衫=ㄒㄋㄕ
吳青峰=ㄨㄑㄈ
澆灌的園子=ㄐㄍㄉㄩㄗ
謝雷,謝小魚=ㄒㄌ,ㄒㄒㄩ
可愛的玫瑰花(純伴奏)=ㄎㄞㄉㄇㄍㄏ(ㄔㄅㄗ)
回不去了嗎=ㄏㄅㄑㄌㄇ
無羈=ㄨㄐ
野狼(純伴奏)=ㄧㄌ(ㄔㄅㄗ)
但是又何奈(純伴奏)=ㄉㄕㄧㄏㄋ(ㄔㄅㄗ)
生而為贏=ㄕㄦㄨㄧ
辣台妹=ㄌㄊㄇ
失樂=ㄕㄌ
可惜沒如果=ㄎㄒㄇㄖㄍ
像天堂的懸崖=ㄒㄊㄊㄉㄒㄧ
你免同情我=ㄋㄇㄊㄑㄨ
次我愛他=ㄘㄨㄞㄊ
邱鋒澤=ㄑㄈㄗ
博杯(純伴奏)=ㄅㄅ(ㄔㄅㄗ)
五月天,陳綺貞=ㄨㄩㄊ,ㄔㄑㄓ
消息=ㄒㄒ
開門見山=ㄎㄇㄐㄕ
我的一個道姑朋友(純伴奏)=ㄨㄉㄧㄍㄉㄍㄆㄧ(ㄔㄅㄗ)
不專心=ㄅㄓㄒ
離別的酒=ㄌㄅㄉㄐ
飆汗=ㄅㄏ
同手同腳=ㄊㄕㄊㄐ
歲月神偷=ㄙㄩㄕㄊ
風(純伴奏)=ㄈ(ㄔㄅㄗ)
歌之王(純伴奏)=ㄍㄓㄨ(ㄔㄅㄗ)
風再起時(純伴奏)=ㄈㄗㄑㄕ(ㄔㄅㄗ)
愛過你這件事=ㄞㄍㄋㄓㄐㄕ
張清芳,優客李林=ㄓㄑㄈ,ㄧㄎㄌㄌ
花粥,馬雨陽=ㄏㄓ,ㄇㄩㄧ
離別的月台票(純伴奏)=ㄌㄅㄉㄩㄊㄆ(ㄔㄅㄗ)
回音哥=ㄏㄧㄍ
我怎麼這麼好看(純伴奏)=ㄨㄗㄇㄓㄇㄏㄎ(ㄔㄅㄗ)
怪美的(純伴奏)=ㄍㄇㄉ(ㄔㄅㄗ)
很需要(純伴奏)=ㄏㄒㄧ(ㄔㄅㄗ)
夏雨詩=ㄒㄩㄕ
姜玉陽=ㄐㄩㄧ
陳綺貞=ㄔㄑㄓ
感謝你曾來過(純伴奏)=ㄍㄒㄋㄘㄌㄍ(ㄔㄅㄗ)
汪峰=ㄨㄈ
都給你說就好=ㄉㄍㄋㄕㄐㄏ
來去卡拉=ㄌㄑㄎㄌ
備愛=ㄅㄞ
成全(純伴奏)=ㄔㄑ(ㄔㄅㄗ)
再見吧!惡魔=ㄗㄐㄅ!ㄜㄇ
搖落=ㄧㄌ
開場白=ㄎㄔㄅ
入陣曲=ㄖㄓㄑ
不曾回來過=ㄅㄘㄏㄌㄍ
街燈下=ㄐㄉㄒ
年的聖誕節=ㄋㄉㄕㄉㄐ
我在你身旁=ㄨㄗㄋㄕㄆ
芹菜=ㄑㄘ
愛到最高點=ㄞㄉㄗㄍㄉ
人生公路=ㄖㄕㄍㄌ
蝴蝶之夏(純伴奏)=ㄏㄉㄓㄒ(ㄔㄅㄗ)
向前走=ㄒㄑㄗ
走心(純伴奏)=ㄗㄒ(ㄔㄅㄗ)
李崗霖=ㄌㄍㄌ
愛自己更深=ㄞㄗㄐㄍㄕ
謝銘祐=ㄒㄇㄧ
痴心的玫瑰=ㄔㄒㄉㄇㄍ
看透=ㄎㄊ
馮提莫=ㄈㄊㄇ
真心真意=ㄓㄒㄓㄧ
林采緹=ㄌㄘㄊ
謝謝你的美好=ㄒㄒㄋㄉㄇㄏ
兩只蝴蝶=ㄌㄓㄏㄉ
無眠(純伴奏)=ㄨㄇ(ㄔㄅㄗ)
月亮警察(純伴奏)=ㄩㄌㄐㄔ(ㄔㄅㄗ)
金池=ㄐㄔ
年少有為(純伴奏)=ㄋㄕㄧㄨ(ㄔㄅㄗ)
ë=ë
愛殤=ㄞㄕ
一萬小時=ㄧㄨㄒㄕ
永遠的家=ㄩㄩㄉㄐ
不唱情歌=ㄅㄔㄑㄍ
到底愛我不愛=ㄉㄉㄞㄨㄅㄞ
親愛的那不是愛情=ㄑㄞㄉㄋㄅㄕㄞㄑ
還是要說再見=ㄏㄕㄧㄕㄗㄐ
狠狠愛=ㄏㄏㄞ
運河悲喜曲(純伴奏)=ㄩㄏㄅㄒㄑ(ㄔㄅㄗ)
王奕心=ㄨㄧㄒ
就改天=ㄐㄍㄊ
相信她、關心她=ㄒㄒㄊ、ㄍㄒㄊ
你和我和他之間=ㄋㄏㄨㄏㄊㄓㄐ
上海灘(純伴奏)=ㄕㄏㄊ(ㄔㄅㄗ)
鄭興=ㄓㄒ
今生最愛的人=ㄐㄕㄗㄞㄉㄖ
愛情復興=ㄞㄑㄈㄒ
董育君=ㄉㄩㄐ
紅日=ㄏㄖ
一把無情鹽=ㄧㄅㄨㄑㄧ
羅志祥,徐熙娣=ㄌㄓㄒ,ㄒㄒㄉ
是不是老了=ㄕㄅㄕㄌㄌ
算袂到=ㄙㄇㄉ
楊林=ㄧㄌ
明天，你好=ㄇㄊ，ㄋㄏ
離家出走=ㄌㄐㄔㄗ
孤單心事(純伴奏)=ㄍㄉㄒㄕ(ㄔㄅㄗ)
歪國人=ㄨㄍㄖ
今生的願望(純伴奏)=ㄐㄕㄉㄩㄨ(ㄔㄅㄗ)
愛情釀的酒=ㄞㄑㄋㄉㄐ
以斯拉=ㄧㄙㄌ
我比他好=ㄨㄅㄊㄏ
紙飛機=ㄓㄈㄐ
太坦白=ㄊㄊㄅ
十二種顏色=ㄕㄦㄓㄧㄙ
愛拼才會贏(純伴奏)=ㄞㄆㄘㄏㄧ(ㄔㄅㄗ)
深刻的愛,=ㄕㄎㄉㄞ,
李凱馨=ㄌㄎㄒ
放心=ㄈㄒ
離開愛的日子=ㄌㄎㄞㄉㄖㄗ
最幸福的事(純伴奏)=ㄗㄒㄈㄉㄕ(ㄔㄅㄗ)
汪蘇瀧,=ㄨㄙㄌ,
天空=ㄊㄎ
算什麼男人(純伴奏)=ㄙㄕㄇㄋㄖ(ㄔㄅㄗ)
流浪狗=ㄌㄌㄍ
寄情=ㄐㄑ
我不需要=ㄨㄅㄒㄧ
春風少年兄(純伴奏)=ㄔㄈㄕㄋㄒ(ㄔㄅㄗ)
吉他手=ㄐㄊㄕ
把最甜的都給妳=ㄅㄗㄊㄉㄉㄍㄋ
如果我們再相遇=ㄖㄍㄨㄇㄗㄒㄩ
海草舞=ㄏㄘㄨ
左手指月=ㄗㄕㄓㄩ
陶晶瑩=ㄊㄐㄧ
習慣晚睡=ㄒㄍㄨㄕ
死了都要愛=ㄙㄌㄉㄧㄞ
為愛投降=ㄨㄞㄊㄒ
不要告別=ㄅㄧㄍㄅ
葉詠心=ㄧㄩㄒ
太美麗=ㄊㄇㄌ
記得回來(純伴奏)=ㄐㄉㄏㄌ(ㄔㄅㄗ)
如果你冷=ㄖㄍㄋㄌ
曲肖冰=ㄑㄒㄅ
神話(純伴奏)=ㄕㄏ(ㄔㄅㄗ)
我愛你=ㄨㄞㄋ
放棄你=ㄈㄑㄋ
模特=ㄇㄊ
遺失的美好(純伴奏)=ㄧㄕㄉㄇㄏ(ㄔㄅㄗ)
謝和弦,玖壹壹,陳零九=ㄒㄏㄒ,ㄐㄧㄧ,ㄔㄌㄐ
范曉萱=ㄈㄒㄒ
我以為=ㄨㄧㄨ
不想想太多=ㄅㄒㄒㄊㄉ
無間道=ㄨㄐㄉ
只有孤單陪伴我=ㄓㄧㄍㄉㄆㄅㄨ
歲月如歌=ㄙㄩㄖㄍ
我很快樂(純伴奏)=ㄨㄏㄎㄌ(ㄔㄅㄗ)
祝你幸福=ㄓㄋㄒㄈ
今生愛過的人=ㄐㄕㄞㄍㄉㄖ
還不能哭=ㄏㄅㄋㄎ
我的歌聲裡(純伴奏)=ㄨㄉㄍㄕㄌ(ㄔㄅㄗ)
淡海的藍天=ㄉㄏㄉㄌㄊ
沒那種命=ㄇㄋㄓㄇ
冰的啦=ㄅㄉㄌ
張學友,高慧君=ㄓㄒㄧ,ㄍㄏㄐ
黃明志,動力火車=ㄏㄇㄓ,ㄉㄌㄏㄔ
詹雅雯=ㄓㄧㄨ
心頭鎖=ㄒㄊㄙ
為你變成他(純伴奏)=ㄨㄋㄅㄔㄊ(ㄔㄅㄗ)
八字命=ㄅㄗㄇ
你是我心中最想離開的依戀=ㄋㄕㄨㄒㄓㄗㄒㄌㄎㄉㄧㄌ
喜劇之王=ㄒㄐㄓㄨ
曾心梅=ㄘㄒㄇ
大合唱=ㄉㄏㄔ
深深不了情=ㄕㄕㄅㄌㄑ
夢中恰恰(純伴奏)=ㄇㄓㄑㄑ(ㄔㄅㄗ)
浪費=ㄌㄈ
超有感=ㄔㄧㄍ
回憶那麼傷=ㄏㄧㄋㄇㄕ
甘願=ㄍㄩ
孤戀花=ㄍㄌㄏ
不公平=ㄅㄍㄆ
心太軟(純伴奏)=ㄒㄊㄖ(ㄔㄅㄗ)
運氣來得若有似無=ㄩㄑㄌㄉㄖㄧㄙㄨ
沒那麼簡單=ㄇㄋㄇㄐㄉ
你怕不怕失去我=ㄋㄆㄅㄆㄕㄑㄨ
天頂的月娘=ㄊㄉㄉㄩㄋ
凜冬將至=ㄌㄉㄐㄓ
早知道愛上你=ㄗㄓㄉㄞㄕㄋ
她的背影=ㄊㄉㄅㄧ
你的情歌=ㄋㄉㄑㄍ
哀愁=ㄞㄔ
友情歲月(純伴奏)=ㄧㄑㄙㄩ(ㄔㄅㄗ)
我是一隻畫眉鳥(純伴奏)=ㄨㄕㄧㄓㄏㄇㄋ(ㄔㄅㄗ)
當時欲嫁=ㄉㄕㄩㄐ
我沒有瘋=ㄨㄇㄧㄈ
愛總那麼傷人=ㄞㄗㄋㄇㄕㄖ
南庄細妹(純伴奏)=ㄋㄓㄒㄇ(ㄔㄅㄗ)
歸去來兮=ㄍㄑㄌㄒ
歌之王=ㄍㄓㄨ
仝款的月娘=ㄊㄎㄉㄩㄋ
夜盲症=ㄧㄇㄓ
陌生的人=ㄇㄕㄉㄖ
斷橋離情=ㄉㄑㄌㄑ
大人中=ㄉㄖㄓ
愛情一陣風=ㄞㄑㄧㄓㄈ
蕭亞軒=ㄒㄧㄒ
一萬個理由=ㄧㄨㄍㄌㄧ
心愛的甭哭=ㄒㄞㄉㄅㄎ
腳步=ㄐㄅ
真的好愛你=ㄓㄉㄏㄞㄋ
讓我為你唱情歌=ㄖㄨㄨㄋㄔㄑㄍ
醒來=ㄒㄌ
江南=ㄐㄋ
小暑=ㄒㄕ
旅程=ㄌㄔ
諾言=ㄋㄧ
你要的全拿走=ㄋㄧㄉㄑㄋㄗ
藍眼睛=ㄌㄧㄐ
不關你的事=ㄅㄍㄋㄉㄕ
天天年年=ㄊㄊㄋㄋ
親人=ㄑㄖ
我是誰我是誰我是誰(純伴奏)=ㄨㄕㄕㄨㄕㄕㄨㄕㄕ(ㄔㄅㄗ)
來不及對不起=ㄌㄅㄐㄉㄅㄑ
一暝三冬(純伴奏)=ㄧㄇㄙㄉ(ㄔㄅㄗ)
恩典之路=ㄣㄉㄓㄌ
初見=ㄔㄐ
葉璦菱,孫建平=ㄧㄞㄌ,ㄙㄐㄆ
汪東城=ㄨㄉㄔ
對號入座=ㄉㄏㄖㄗ
鳥羽一郎=ㄋㄩㄧㄌ
孟耿如劉以豪=ㄇㄍㄖㄌㄧㄏ
能不能勇敢說愛=ㄋㄅㄋㄩㄍㄕㄞ
一切歌頌讚美=ㄧㄑㄍㄙㄗㄇ
記事本(純伴奏)=ㄐㄕㄅ(ㄔㄅㄗ)
心頭肉=ㄒㄊㄖ
帶我去月球=ㄉㄨㄑㄩㄑ
神同在=ㄕㄊㄗ
易燃易爆炸(純伴奏)=ㄧㄖㄧㄅㄓ(ㄔㄅㄗ)
大人物=ㄉㄖㄨ
將故事寫成我們=ㄐㄍㄕㄒㄔㄨㄇ
陪我到以後(純伴奏)=ㄆㄨㄉㄧㄏ(ㄔㄅㄗ)
謝霆鋒=ㄒㄊㄈ
風鈴聲=ㄈㄌㄕ
裏町人生=ㄌㄊㄖㄕ
童年=ㄊㄋ
十一哥(純伴奏)=ㄕㄧㄍ(ㄔㄅㄗ)
感謝無情人=ㄍㄒㄨㄑㄖ
慢走不送=ㄇㄗㄅㄙ
太多太多的抱歉=ㄊㄉㄊㄉㄉㄅㄑ
王艷薇=ㄨㄧㄨ
繼續轉動=ㄐㄒㄓㄉ
笑青春=ㄒㄑㄔ
紅蓮の弓矢=ㄏㄌのㄍㄕ
謝沛恩=ㄒㄆㄣ
忘川河=ㄨㄔㄏ
許志安=ㄒㄓㄢ
聰明糊塗心=ㄘㄇㄏㄊㄒ
海綿寶寶=ㄏㄇㄅㄅ
想你的夜=ㄒㄋㄉㄧ
鬥牛=ㄉㄋ
魏如萱=ㄨㄖㄒ
最後一次=ㄗㄏㄧㄘ
我懷念的(純伴奏)=ㄨㄏㄋㄉ(ㄔㄅㄗ)
戒菸=ㄐㄧ
今天沒回家=ㄐㄊㄇㄏㄐ
愛你愛到變成一首歌=ㄞㄋㄞㄉㄅㄔㄧㄕㄍ
她說(純伴奏)=ㄊㄕ(ㄔㄅㄗ)
思鄉情歌(純伴奏)=ㄙㄒㄑㄍ(ㄔㄅㄗ)
阿郎阿郎=ㄚㄌㄚㄌ
只願和你相愛=ㄓㄩㄏㄋㄒㄞ
有心人=ㄧㄒㄖ
偉大的渺小(純伴奏)=ㄨㄉㄉㄇㄒ(ㄔㄅㄗ)
愛．這件事情=ㄞ．ㄓㄐㄕㄑ
為你我受冷風吹=ㄨㄋㄨㄕㄌㄈㄔ
黃明志,大支=ㄏㄇㄓ,ㄉㄓ
兩人份美好=ㄌㄖㄈㄇㄏ
認識你真好=ㄖㄕㄋㄓㄏ
成名在望=ㄔㄇㄗㄨ
純屬意外=ㄔㄕㄧㄨ
鳥の詩=ㄋのㄕ
特種部隊=ㄊㄓㄅㄉ
如果的事=ㄖㄍㄉㄕ
愛你在心口難開=ㄞㄋㄗㄒㄎㄋㄎ
梁心頤=ㄌㄒㄧ
王冕=ㄨㄇ
一如當初=ㄧㄖㄉㄔ
愛不再呼吸=ㄞㄅㄗㄏㄒ
追夢人=ㄓㄇㄖ
林淑容,羅時豐=ㄌㄕㄖ,ㄌㄕㄈ
出神入化=ㄔㄕㄖㄏ
楊靜=ㄧㄐ
港都夜雨(純伴奏)=ㄍㄉㄧㄩ(ㄔㄅㄗ)
古巨基=ㄍㄐㄐ
黃氏兄弟=ㄏㄕㄒㄉ
這種天真=ㄓㄓㄊㄓ
情話綿綿=ㄑㄏㄇㄇ
港邊乾杯=ㄍㄅㄍㄅ
明天的自己=ㄇㄊㄉㄗㄐ
楊哲,談詩玲=ㄧㄓ,ㄊㄕㄌ
奮鬥的歌手=ㄈㄉㄉㄍㄕ
美麗人生=ㄇㄌㄖㄕ
整晚的音樂=ㄓㄨㄉㄧㄩ
我就是愛你不害怕=ㄨㄐㄕㄞㄋㄅㄏㄆ
了斷=ㄌㄉ
永遠永遠=ㄩㄩㄩㄩ
用眼淚還給你=ㄩㄧㄌㄏㄍㄋ
關於孤獨我想說的話=ㄍㄩㄍㄉㄨㄒㄕㄉㄏ
打破他=ㄉㄆㄊ
一眼瞬間=ㄧㄧㄕㄐ
地平線=ㄉㄆㄒ
刀劍如夢(純伴奏)=ㄉㄐㄖㄇ(ㄔㄅㄗ)
你要的全拿走(純伴奏)=ㄋㄧㄉㄑㄋㄗ(ㄔㄅㄗ)
恩典的記號=ㄣㄉㄉㄐㄏ
鄧福如=ㄉㄈㄖ
我已得自由=ㄨㄧㄉㄗㄧ
還有呼吸就愛你=ㄏㄧㄏㄒㄐㄞㄋ
正月調=ㄓㄩㄊ
五月天,鄧紫棋=ㄨㄩㄊ,ㄉㄗㄑ
寂寞邊界=ㄐㄇㄅㄐ
因果=ㄧㄍ
瘦子,=ㄕㄗ,
不要愛我=ㄅㄧㄞㄨ
你走你的路=ㄋㄗㄋㄉㄌ
張紫豪=ㄓㄗㄏ
一生中最愛=ㄧㄕㄓㄗㄞ
時間沙=ㄕㄐㄕ
愛你勝過我=ㄞㄋㄕㄍㄨ
梅香如故=ㄇㄒㄖㄍ
勢在必行=ㄕㄗㄅㄒ
公轉自轉=ㄍㄓㄗㄓ
潘越雲=ㄆㄩㄩ
江志豐,張秀卿=ㄐㄓㄈ,ㄓㄒㄑ
三萬英尺=ㄙㄨㄧㄔ
大夢想家=ㄉㄇㄒㄐ
山海=ㄕㄏ
陳淑芬與林志豪=ㄔㄕㄈㄩㄌㄓㄏ
你太誠實=ㄋㄊㄔㄕ
心痛的感覺(純伴奏)=ㄒㄊㄉㄍㄐ(ㄔㄅㄗ)
意外(純伴奏)=ㄧㄨ(ㄔㄅㄗ)
手=ㄕ
差一步=ㄔㄧㄅ
台北某個地方=ㄊㄅㄇㄍㄉㄈ
別了瘋子=ㄅㄌㄈㄗ
就這樣嗎=ㄐㄓㄧㄇ
玖壹壹,羅志祥=ㄐㄧㄧ,ㄌㄓㄒ
輸了你贏了世界又如何=ㄕㄌㄋㄧㄌㄕㄐㄧㄖㄏ
迷迭香=ㄇㄉㄒ
陳芬蘭=ㄔㄈㄌ
媽媽我想你=ㄇㄇㄨㄒㄋ
一步一步愛=ㄧㄅㄧㄅㄞ
狂想曲=ㄎㄒㄑ
感恩的滋味=ㄍㄣㄉㄗㄨ
林啟得=ㄌㄑㄉ
推開世界的門(純伴奏)=ㄊㄎㄕㄐㄉㄇ(ㄔㄅㄗ)
楊坤=ㄧㄎ
方怡萍=ㄈㄧㄆ
大海(純伴奏)=ㄉㄏ(ㄔㄅㄗ)
陳盈潔=ㄔㄧㄐ
點水=ㄉㄕ
一半人生=ㄧㄅㄖㄕ
微笑的力量=ㄨㄒㄉㄌㄌ
呼呼=ㄏㄏ
齊來讚美=ㄑㄌㄗㄇ
張智成=ㄓㄓㄔ
陳勢安,畢書盡=ㄔㄕㄢ,ㄅㄕㄐ
野狼=ㄧㄌ
你是你的=ㄋㄕㄋㄉ
畢書盡,陳勢安,陳彥允,李玉璽=ㄅㄕㄐ,ㄔㄕㄢ,ㄔㄧㄩ,ㄌㄩㄒ
一個人生活(幸福蛻變版)=ㄧㄍㄖㄕㄏ(ㄒㄈㄊㄅㄅ)
無樂不作(純伴奏)=ㄨㄌㄅㄗ(ㄔㄅㄗ)
王海玲=ㄨㄏㄌ
要去高雄=ㄧㄑㄍㄒ
你看不見的天空=ㄋㄎㄅㄐㄉㄊㄎ
幸福的孤單=ㄒㄈㄉㄍㄉ
你,好不好?=ㄋ,ㄏㄅㄏ?
林宇中=ㄌㄩㄓ
太傻了=ㄊㄕㄌ
我的心太亂=ㄨㄉㄒㄊㄌ
我知道你都知道(純伴奏)=ㄨㄓㄉㄋㄉㄓㄉ(ㄔㄅㄗ)
擎歌=ㄑㄍ
半夢半醒之間=ㄅㄇㄅㄒㄓㄐ
我為你傷心=ㄨㄨㄋㄕㄒ
檸檬草的味道=ㄋㄇㄘㄉㄨㄉ
我要順服=ㄨㄧㄕㄈ
痛哭的人=ㄊㄎㄉㄖ
悲情歌聲=ㄅㄑㄍㄕ
總算我們也愛過=ㄗㄙㄨㄇㄧㄞㄍ
我要我們在一起=ㄨㄧㄨㄇㄗㄧㄑ
可樂戒指=ㄎㄌㄐㄓ
最後情人(純伴奏)=ㄗㄏㄑㄖ(ㄔㄅㄗ)
我感覺不到你=ㄨㄍㄐㄅㄉㄋ
李建軒=ㄌㄐㄒ
當我們不在一起=ㄉㄨㄇㄅㄗㄧㄑ
一步一步行=ㄧㄅㄧㄅㄒ
星星月亮太陽=ㄒㄒㄩㄌㄊㄧ
彭佳慧,范瑋琪=ㄆㄐㄏ,ㄈㄨㄑ
難忘的初戀情人(閩南語)=ㄋㄨㄉㄔㄌㄑㄖ(ㄇㄋㄩ)
淚的小雨=ㄌㄉㄒㄩ
蔡恩雨=ㄘㄣㄩ
鄭中基=ㄓㄓㄐ
悔=ㄏ
成功的條件=ㄔㄍㄉㄊㄐ
陳子晴=ㄔㄗㄑ
放棄你(純伴奏)=ㄈㄑㄋ(ㄔㄅㄗ)
許飛=ㄒㄈ
悲歌=ㄅㄍ
還是愛著你=ㄏㄕㄞㄓㄋ
說散就散(純伴奏)=ㄕㄙㄐㄙ(ㄔㄅㄗ)
李英宏=ㄌㄧㄏ
千年之旅=ㄑㄋㄓㄌ
黑夜問白天=ㄏㄧㄨㄅㄊ
比我幸福=ㄅㄨㄒㄈ
夢中的愛=ㄇㄓㄉㄞ
酒女夢=ㄐㄋㄇ
無法抗拒的愛=ㄨㄈㄎㄐㄉㄞ
思念你的心肝你敢知=ㄙㄋㄋㄉㄒㄍㄋㄍㄓ
怎麼還不愛=ㄗㄇㄏㄅㄞ
莊鵑瑛=ㄓㄐㄧ
遇到=ㄩㄉ
石頭心=ㄕㄊㄒ
女神降臨=ㄋㄕㄐㄌ
叭噗叭噗=ㄅㄆㄅㄆ
禁愛令=ㄐㄞㄌ
的點歌心情=ㄉㄉㄍㄒㄑ
我做你的靠山=ㄨㄗㄋㄉㄎㄕ
唱乎甲己來聽=ㄔㄏㄐㄐㄌㄊ
眼淚的名字=ㄧㄌㄉㄇㄗ
人生(純伴奏)=ㄖㄕ(ㄔㄅㄗ)
汗水的重量=ㄏㄕㄉㄓㄌ
張洪量=ㄓㄏㄌ
催眠=ㄘㄇ
許哲珮=ㄒㄓㄆ
說愛你以後=ㄕㄞㄋㄧㄏ
單車=ㄉㄔ
奔向未來日子=ㄅㄒㄨㄌㄖㄗ
夢駝鈴=ㄇㄊㄌ
同款的月娘=ㄊㄎㄉㄩㄋ
空空如也=ㄎㄎㄖㄧ
度=ㄉ
為你的寂寞唱歌=ㄨㄋㄉㄐㄇㄔㄍ
新竹女中屆=ㄒㄓㄋㄓㄐ
千紙鶴=ㄑㄓㄏ
無緣的牽掛=ㄨㄩㄉㄑㄍ
夢醒時分=ㄇㄒㄕㄈ
多想告訴你=ㄉㄒㄍㄙㄋ
好神拖=ㄏㄕㄊ
雙雙飛=ㄕㄕㄈ
可憐的酒家女=ㄎㄌㄉㄐㄐㄋ
中國娃娃=ㄓㄍㄨㄨ
整個八月=ㄓㄍㄅㄩ
公主時代=ㄍㄓㄕㄉ
茫茫到深更=ㄇㄇㄉㄕㄐ
寂寞沙洲冷=ㄐㄇㄕㄓㄌ
懷念的播音員=ㄏㄋㄉㄅㄧㄩ
分享愛=ㄈㄒㄞ
姐=ㄐ
玫瑰玫瑰我愛你=ㄇㄍㄇㄍㄨㄞㄋ
牽你的手=ㄑㄋㄉㄕ
其實還愛你=ㄑㄕㄏㄞㄋ
青春住了誰=ㄑㄔㄓㄌㄕ
曾仲瑋=ㄘㄓㄨ
誰人甲我比=ㄕㄖㄐㄨㄅ
韓紅,孫楠=ㄏㄏ,ㄙㄋ
女人說=ㄋㄖㄕ
輕樂心=ㄑㄌㄒ
黃妃=ㄏㄈ
五月的風=ㄨㄩㄉㄈ
自己=ㄗㄐ
分生=ㄈㄕ
快樂至上=ㄎㄌㄓㄕ
驕傲的少年=ㄐㄠㄉㄕㄋ
故鄉的地圖=ㄍㄒㄉㄉㄊ
絲路=ㄙㄌ
唯一=ㄨㄧ
黑白無常=ㄏㄅㄨㄔ
同恩=ㄊㄣ
後來遇見他(純伴奏)=ㄏㄌㄩㄐㄊ(ㄔㄅㄗ)
東方之珠=ㄉㄈㄓㄓ
愛人仔恰恰=ㄞㄖㄗㄑㄑ
是誰說過=ㄕㄕㄕㄍ
吻別=ㄨㄅ
醉赤壁=ㄗㄔㄅ
王力宏=ㄨㄌㄏ
西瓜=ㄒㄍ
夢飛船=ㄇㄈㄔ
曾之喬=ㄘㄓㄑ
歪腰=ㄨㄧ
大女人=ㄉㄋㄖ
我還是愛著你=ㄨㄏㄕㄞㄓㄋ
一次幸福的機會=ㄧㄘㄒㄈㄉㄐㄏ
夏至未至=ㄒㄓㄨㄓ
瑪莉咬凱利=ㄇㄌㄧㄎㄌ
睡不著=ㄕㄅㄓ
金志文=ㄐㄓㄨ
你就不要想起我(純伴奏)=ㄋㄐㄅㄧㄒㄑㄨ(ㄔㄅㄗ)
人生超幽默=ㄖㄕㄔㄧㄇ
謝謝你的愛=ㄒㄒㄋㄉㄞ
初戀(純伴奏)=ㄔㄌ(ㄔㄅㄗ)
真的假的=ㄓㄉㄐㄉ
卡加布列島=ㄎㄐㄅㄌㄉ
張清芳=ㄓㄑㄈ
秋纏=ㄑㄔ
你不要那樣看著我的眼睛=ㄋㄅㄧㄋㄧㄎㄓㄨㄉㄧㄐ
以後要做的事=ㄧㄏㄧㄗㄉㄕ
王=ㄨ
六月割菜假有心=ㄌㄩㄍㄘㄐㄧㄒ
容易受傷的女人=ㄖㄧㄕㄕㄉㄋㄖ
周杰倫,洪榮宏=ㄓㄐㄌ,ㄏㄖㄏ
揮之不去=ㄏㄓㄅㄑ
幸福乾杯=ㄒㄈㄍㄅ
龍千玉,傅振輝=ㄌㄑㄩ,ㄈㄓㄏ
忘了如何遺忘=ㄨㄌㄖㄏㄧㄨ
室友=ㄕㄧ
思念的日子=ㄙㄋㄉㄖㄗ
想和你去吹吹風=ㄒㄏㄋㄑㄔㄔㄈ
賜我自由=ㄘㄨㄗㄧ
張鎬哲=ㄓㄏㄓ
夢醒時分(純伴奏)=ㄇㄒㄕㄈ(ㄔㄅㄗ)
框不住的愛(純伴奏)=ㄎㄅㄓㄉㄞ(ㄔㄅㄗ)
時間煮雨=ㄕㄐㄓㄩ
沒差=ㄇㄔ
失敗的分手=ㄕㄅㄉㄈㄕ
愛情的故事(純伴奏)=ㄞㄑㄉㄍㄕ(ㄔㄅㄗ)
看不見=ㄎㄅㄐ
毛毛雨(純伴奏)=ㄇㄇㄩ(ㄔㄅㄗ)
都是真的=ㄉㄕㄓㄉ
心酸的浪漫=ㄒㄙㄉㄌㄇ
伍佰,萬芳=ㄨㄅ,ㄨㄈ
二本貓=ㄦㄅㄇ
莫文蔚,李宗盛=ㄇㄨㄨ,ㄌㄗㄕ
自我催眠=ㄗㄨㄘㄇ
給自己的情歌=ㄍㄗㄐㄉㄑㄍ
土耳其冰淇淋=ㄊㄦㄑㄅㄑㄌ
凡人歌火=ㄈㄖㄍㄏ
忘了愛=ㄨㄌㄞ
溫柔名片=ㄨㄖㄇㄆ
我們不是公主=ㄨㄇㄅㄕㄍㄓ
李碧華=ㄌㄅㄏ
仰望恩典=ㄧㄨㄣㄉ
心如止水=ㄒㄖㄓㄕ
曖昧(純伴奏)=ㄞㄇ(ㄔㄅㄗ)
匆匆那年=ㄘㄘㄋㄋ
王啟文=ㄨㄑㄨ
成長之重量=ㄔㄓㄓㄓㄌ
不還(純伴奏)=ㄅㄏ(ㄔㄅㄗ)
十八般武藝=ㄕㄅㄅㄨㄧ
洪佩瑜=ㄏㄆㄩ
就微笑了=ㄐㄨㄒㄌ
走向我･走向你=ㄗㄒㄨ･ㄗㄒㄋ
路口=ㄌㄎ
十字架(純伴奏)=ㄕㄗㄐ(ㄔㄅㄗ)
中華民國頌=ㄓㄏㄇㄍㄙ
黃明志,黃安熙=ㄏㄇㄓ,ㄏㄢㄒ
為你貼心肝=ㄨㄋㄊㄒㄍ
忘記你我做不到=ㄨㄐㄋㄨㄗㄅㄉ
不甘寂寞=ㄅㄍㄐㄇ
我恨你我愛你=ㄨㄏㄋㄨㄞㄋ
魚(純伴奏)=ㄩ(ㄔㄅㄗ)
微風往事=ㄨㄈㄨㄕ
淚滴=ㄌㄉ
顏冠希濁水溪公社/柯董=ㄧㄍㄒㄓㄕㄒㄍㄕ/ㄎㄉ
有你就夠了=ㄧㄋㄐㄍㄌ
沉睡的野獸=ㄔㄕㄉㄧㄕ
愛情的陷阱=ㄞㄑㄉㄒㄐ
出山=ㄔㄕ
我要的幸福=ㄨㄧㄉㄒㄈ
夢想藍圖=ㄇㄒㄌㄊ
榕樹下(純伴奏)=ㄖㄕㄒ(ㄔㄅㄗ)
我恨我愛你=ㄨㄏㄨㄞㄋ
親愛耶穌醫治救主=ㄑㄞㄧㄙㄧㄓㄐㄓ
晚安曲=ㄨㄢㄑ
吳汶芳=ㄨㄨㄈ
新音樂敬拜創作=ㄒㄧㄩㄐㄅㄔㄗ
&王倩倩=&ㄨㄑㄑ
是你變了嗎=ㄕㄋㄅㄌㄇ
倫桑=ㄌㄙ
我害怕=ㄨㄏㄆ
夢中的新娘=ㄇㄓㄉㄒㄋ
戇甲有賰=ㄓㄐㄧㄕ
熊天平,齊秦=ㄒㄊㄆ,ㄑㄑ
冬戀=ㄉㄌ
楊靜,李明洋=ㄧㄐ,ㄌㄇㄧ
速食愛情=ㄙㄕㄞㄑ
你啊你啊(純伴奏)=ㄋㄚㄋㄚ(ㄔㄅㄗ)
大小姐=ㄉㄒㄐ
不願認輸=ㄅㄩㄖㄕ
玻璃=ㄅㄌ
砍掉重練=ㄎㄉㄔㄌ
魔鬼中的天使(純伴奏)=ㄇㄍㄓㄉㄊㄕ(ㄔㄅㄗ)
相見不如懷念(純伴奏)=ㄒㄐㄅㄖㄏㄋ(ㄔㄅㄗ)
痛哭=ㄊㄎ
鄭宜農=ㄓㄧㄋ
我的淚=ㄨㄉㄌ
白日夢=ㄅㄖㄇ
少年他的奇幻漂流=ㄕㄋㄊㄉㄑㄏㄆㄌ
戀愛大過天=ㄌㄞㄉㄍㄊ
斷點(純伴奏)=ㄉㄉ(ㄔㄅㄗ)
趁早=ㄔㄗ
我還是一樣=ㄨㄏㄕㄧㄧ
命運的吉他=ㄇㄩㄉㄐㄊ
反義詞=ㄈㄧㄘ
好喜歡你=ㄏㄒㄏㄋ
陳政文=ㄔㄓㄨ
大海=ㄉㄏ
思念的情淚=ㄙㄋㄉㄑㄌ
值得=ㄓㄉ
戀上一個人=ㄌㄕㄧㄍㄖ
甲乙丙丁=ㄐㄧㄅㄉ
攏是為著你啦=ㄌㄕㄨㄓㄋㄌ
禁愛令(純伴奏)=ㄐㄞㄌ(ㄔㄅㄗ)
風塊哭=ㄈㄎㄎ
心酸的成熟=ㄒㄙㄉㄔㄕ
全放空(純伴奏)=ㄑㄈㄎ(ㄔㄅㄗ)
陳夏蓮=ㄔㄒㄌ
我愛的人不愛我=ㄨㄞㄉㄖㄅㄞㄨ
祝我生日快樂=ㄓㄨㄕㄖㄎㄌ
暮光=ㄇㄍ
阿沁=ㄚㄑ
張淑美=ㄓㄕㄇ
新年快樂=ㄒㄋㄎㄌ
夜市人生=ㄧㄕㄖㄕ
沸騰=ㄈㄊ
沙漠駱駝(純伴奏)=ㄕㄇㄌㄊ(ㄔㄅㄗ)
門=ㄇ
八三夭=ㄅㄙㄧ
月娘啊！聽我講=ㄩㄋㄚ！ㄊㄨㄐ
不愛你愛誰(純伴奏)=ㄅㄞㄋㄞㄕ(ㄔㄅㄗ)
問=ㄨ
走跳=ㄗㄊ
寶貴十架=ㄅㄍㄕㄐ
黄磊=ㄏㄌ
楊靜,林俊吉=ㄧㄐ,ㄌㄐㄐ
回憶總想哭=ㄏㄧㄗㄒㄎ
江蕙,伍思凱=ㄐㄏ,ㄨㄙㄎ
女人的心願=ㄋㄖㄉㄒㄩ
飛機場的:=ㄈㄐㄔㄉ:
一千遍我愛你=ㄧㄑㄅㄨㄞㄋ
時光話=ㄕㄍㄏ
五月天,田馥甄=ㄨㄩㄊ,ㄊㄈㄓ
喬幼,陳隨意=ㄑㄧ,ㄔㄙㄧ
壞習慣=ㄏㄒㄍ
兄弟=ㄒㄉ
濃妝搖滾(純伴奏)=ㄋㄓㄧㄍ(ㄔㄅㄗ)
負心的人(純伴奏)=ㄈㄒㄉㄖ(ㄔㄅㄗ)
晴天=ㄑㄊ
沙灘=ㄕㄊ
大喜宙=ㄉㄒㄓ
紳士=ㄕㄕ
伯樂=ㄅㄌ
天黑請閉眼(純伴奏)=ㄊㄏㄑㄅㄧ(ㄔㄅㄗ)
桃花鄉=ㄊㄏㄒ
官恩娜=ㄍㄣㄋ
孤枕難眠=ㄍㄓㄋㄇ
優點=ㄧㄉ
你說的=ㄋㄕㄉ
車立志=ㄔㄌㄓ
南北征戰=ㄋㄅㄓㄓ
這是最後一次=ㄓㄕㄗㄏㄧㄘ
李克勤=ㄌㄎㄑ
持修=ㄔㄒ
一同起舞\=ㄧㄊㄑㄨ\
陳思安=ㄔㄙㄢ
我知道你都知道=ㄨㄓㄉㄋㄉㄓㄉ
灰色と青=ㄏㄙとㄑ
錯再錯=ㄘㄗㄘ
全能上帝是我的主我的神=ㄑㄋㄕㄉㄕㄨㄉㄓㄨㄉㄕ
平井大=ㄆㄐㄉ
歌頌者=ㄍㄙㄓ
是真的=ㄕㄓㄉ
奥華子=ㄠㄏㄗ
到此為止=ㄉㄘㄨㄓ
涼涼=ㄌㄌ
捲菸=ㄐㄧ
阮若打開心內門窗=ㄖㄖㄉㄎㄒㄋㄇㄔ
江蕙,陳嘉樺=ㄐㄏ,ㄔㄐㄏ
不該用情(純伴奏)=ㄅㄍㄩㄑ(ㄔㄅㄗ)
奔跑不放棄=ㄅㄆㄅㄈㄑ
濃妝搖滾=ㄋㄓㄧㄍ
我要夏天=ㄨㄧㄒㄊ
多想愛你(純伴奏)=ㄉㄒㄞㄋ(ㄔㄅㄗ)
清明上河圖=ㄑㄇㄕㄏㄊ
美麗謊言=ㄇㄌㄏㄧ
落葉歸根=ㄌㄧㄍㄍ
老爺車=ㄌㄧㄔ
男性的純情=ㄋㄒㄉㄔㄑ
倪安東=ㄋㄢㄉ
星火(純伴奏)=ㄒㄏ(ㄔㄅㄗ)
心牆=ㄒㄑ
只對你有感覺=ㄓㄉㄋㄧㄍㄐ
不喜歡補習班=ㄅㄒㄏㄅㄒㄅ
猶大的獅子=ㄧㄉㄉㄕㄗ
你是真的離開我=ㄋㄕㄓㄉㄌㄎㄨ
蜂鳥=ㄈㄋ
私奔到月球(純伴奏)=ㄙㄅㄉㄩㄑ(ㄔㄅㄗ)
鐵罐咖啡=ㄊㄍㄎㄈ
賴慧如,張文綺=ㄌㄏㄖ,ㄓㄨㄑ
為愛痴狂(純伴奏)=ㄨㄞㄔㄎ(ㄔㄅㄗ)
王笠人=ㄨㄌㄖ
黃明志,王力宏=ㄏㄇㄓ,ㄨㄌㄏ
出口=ㄔㄎ
周興哲,許瑋甯=ㄓㄒㄓ,ㄒㄨㄋ
兩名男子街頭相遇=ㄌㄇㄋㄗㄐㄊㄒㄩ
風中的花蕊=ㄈㄓㄉㄏㄖ
韓紅,林俊傑=ㄏㄏ,ㄌㄐㄐ
喔喔=ㄨㄨ
麋先生=ㄇㄒㄕ
是什麼讓我遇見這樣的你(純伴奏)=ㄕㄕㄇㄖㄨㄩㄐㄓㄧㄉㄋ(ㄔㄅㄗ)
命運(純伴奏)=ㄇㄩ(ㄔㄅㄗ)
十萬毫升淚水譜面=ㄕㄨㄏㄕㄌㄕㄆㄇ
魔法城堡=ㄇㄈㄔㄅ
生命河流=ㄕㄇㄏㄌ
翻白眼=ㄈㄅㄧ
盧靜怡=ㄌㄐㄧ
註定=ㄓㄉ
李毓芬=ㄌㄩㄈ
只因為你=ㄓㄧㄨㄋ
一起去跑步=ㄧㄑㄑㄆㄅ
八三夭,房東的貓=ㄅㄙㄧ,ㄈㄉㄉㄇ
越愛越好=ㄩㄞㄩㄏ
小雨中的回憶=ㄒㄩㄓㄉㄏㄧ
色情男女=ㄙㄑㄋㄋ
同心高舉十架=ㄊㄒㄍㄐㄕㄐ
河邊春夢=ㄏㄅㄔㄇ
李子森=ㄌㄗㄙ
小李飛刀=ㄒㄌㄈㄉ
跟隨到底=ㄍㄙㄉㄉ
暫時的男朋友=ㄓㄕㄉㄋㄆㄧ
痛快=ㄊㄎ
花無雪=ㄏㄨㄒ
神秘河流=ㄕㄇㄏㄌ
不是故意=ㄅㄕㄍㄧ
小情歌=ㄒㄑㄍ
江美琪=ㄐㄇㄑ
原來你也在這裡=ㄩㄌㄋㄧㄗㄓㄌ
愛甲超過=ㄞㄐㄔㄍ
塔提雅娜=ㄊㄊㄧㄋ
學你=ㄒㄋ
凡事都有可能=ㄈㄕㄉㄧㄎㄋ
音闕詩聽,王梓鈺=ㄧㄑㄕㄊ,ㄨㄗㄩ
太驕傲=ㄊㄐㄠ
王子音樂=ㄨㄗㄧㄩ
穩贏=ㄨㄧ
藍色啤酒海=ㄌㄙㄆㄐㄏ
范瑋琪,劉若英=ㄈㄨㄑ,ㄌㄖㄧ
陳雪燃=ㄔㄒㄖ
敬拜的心=ㄐㄅㄉㄒ
郁可唯,胡夏=ㄩㄎㄨ,ㄏㄒ
第三杯酒=ㄉㄙㄅㄐ
愛上現在的我=ㄞㄕㄒㄗㄉㄨ
心冷的夢=ㄒㄌㄉㄇ
月光小夜曲=ㄩㄍㄒㄧㄑ
雙人枕頭=ㄕㄖㄓㄊ
愛情你比我想的閣較偉大=ㄞㄑㄋㄅㄨㄒㄉㄍㄐㄨㄉ
天天情人節=ㄊㄊㄑㄖㄐ
說分手之後=ㄕㄈㄕㄓㄏ
黃文星曾昱嘉=ㄏㄨㄒㄘㄩㄐ
速力八=ㄙㄌㄅ
這一路走來=ㄓㄧㄌㄗㄌ
水雲煙=ㄕㄩㄧ
渺小=ㄇㄒ
/=/
處處吻=ㄔㄔㄨ
續集=ㄒㄐ
我的一個道姑朋友=ㄨㄉㄧㄍㄉㄍㄆㄧ
爸爸的夢=ㄅㄅㄉㄇ
愛情切啦=ㄞㄑㄑㄌ
吳莫愁=ㄨㄇㄔ
因為愛=ㄧㄨㄞ
畫沙(純伴奏)=ㄏㄕ(ㄔㄅㄗ)
鵲橋匯=ㄑㄑㄏ
你的名字=ㄋㄉㄇㄗ
等待舞伴=ㄉㄉㄨㄅ
噢買尬=ㄩㄇㄍ
單身的演歌=ㄉㄕㄉㄧㄍ
黃荻鈞=ㄏㄉㄐ
又不是非要你的愛=ㄧㄅㄕㄈㄧㄋㄉㄞ
天后(純伴奏)=ㄊㄏ(ㄔㄅㄗ)
快樂是自找的=ㄎㄌㄕㄗㄓㄉ
思念的海岸=ㄙㄋㄉㄏㄢ
簡單的快樂=ㄐㄉㄉㄎㄌ
獅子合唱團=ㄕㄗㄏㄔㄊ
龍飛,門麗=ㄌㄈ,ㄇㄌ
別問舊傷口=ㄅㄨㄐㄕㄎ
天才與白痴(純伴奏)=ㄊㄘㄩㄅㄔ(ㄔㄅㄗ)
尬舞=ㄍㄨ
清風徐來=ㄑㄈㄒㄌ
好好先生=ㄏㄏㄒㄕ
秋雨彼一暝=ㄑㄩㄅㄧㄇ
我就要=ㄨㄐㄧ
阿哥哥=ㄚㄍㄍ
愛人的心肝=ㄞㄖㄉㄒㄍ
夠愛=ㄍㄞ
李現=ㄌㄒ
愛已經累=ㄞㄧㄐㄌ
如果不是因為你=ㄖㄍㄅㄕㄧㄨㄋ
神羔羊配得=ㄕㄍㄧㄆㄉ
終於了解自由(純伴奏)=ㄓㄩㄌㄐㄗㄧ(ㄔㄅㄗ)
離別的酒(純伴奏)=ㄌㄅㄉㄐ(ㄔㄅㄗ)
等你下課=ㄉㄋㄒㄎ
對的人=ㄉㄉㄖ
多想將一切做得完美(純伴奏)=ㄉㄒㄐㄧㄑㄗㄉㄨㄇ(ㄔㄅㄗ)
不想你也難=ㄅㄒㄋㄧㄋ
雨水=ㄩㄕ
荒山亮=ㄏㄕㄌ
今天清晨=ㄐㄊㄑㄔ
實現=ㄕㄒ
寧願我傷心=ㄋㄩㄨㄕㄒ
誰偷了你的快樂=ㄕㄊㄌㄋㄉㄎㄌ
月亮代表我的心(純伴奏)=ㄩㄌㄉㄅㄨㄉㄒ(ㄔㄅㄗ)
伴(純伴奏)=ㄅ(ㄔㄅㄗ)
晚安歌=ㄨㄢㄍ
給你(純伴奏)=ㄍㄋ(ㄔㄅㄗ)
木頭人=ㄇㄊㄖ
東區東區(純伴奏)=ㄉㄑㄉㄑ(ㄔㄅㄗ)
蘇青=ㄙㄑ
花蕊=ㄏㄖ
你是我所有的=ㄋㄕㄨㄙㄧㄉ
回眸(純伴奏)=ㄏㄇ(ㄔㄅㄗ)
幸災樂禍=ㄒㄗㄌㄏ
舊夢一場=ㄐㄇㄧㄔ
無雙=ㄨㄕ
拔河=ㄅㄏ
蕭煌奇,=ㄒㄏㄑ,
再也沒有=ㄗㄧㄇㄧ
我可以忍受=ㄨㄎㄧㄖㄕ
郭金發=ㄍㄐㄈ
對的人(純伴奏)=ㄉㄉㄖ(ㄔㄅㄗ)
心在故鄉(純伴奏)=ㄒㄗㄍㄒ(ㄔㄅㄗ)
北空港=ㄅㄎㄍ
費玉清=ㄈㄩㄑ
李榮浩=ㄌㄖㄏ
時空寄情=ㄕㄎㄐㄑ
愛存在=ㄞㄘㄗ
生命的太陽=ㄕㄇㄉㄊㄧ
賣笑的傻瓜=ㄇㄒㄉㄕㄍ
愛我的請舉手=ㄞㄨㄉㄑㄐㄕ
箏=ㄓ
不懂愛你=ㄅㄉㄞㄋ
卓依婷=ㄓㄧㄊ
想念自己=ㄒㄋㄗㄐ
下雨的夜晚=ㄒㄩㄉㄧㄨ
我們都寂寞=ㄨㄇㄉㄐㄇ
春神來了=ㄔㄕㄌㄌ
小小蟲(純伴奏)=ㄒㄒㄔ(ㄔㄅㄗ)
一磚一瓦=ㄧㄓㄧㄨ
心時代=ㄒㄕㄉ
飛機=ㄈㄐ
小鎮姑娘=ㄒㄓㄍㄋ
王建傑=ㄨㄐㄐ
魂縈舊夢(純伴奏)=ㄏㄧㄐㄇ(ㄔㄅㄗ)
你走之前=ㄋㄗㄓㄑ
全放空=ㄑㄈㄎ
鱷魚的眼淚=ㄜㄩㄉㄧㄌ
法拉利姐張婷婷=ㄈㄌㄌㄐㄓㄊㄊ
懸崖=ㄒㄧ
浪人琵琶=ㄌㄖㄆㄆ
這裡有榮耀=ㄓㄌㄧㄖㄧ
天使高唱=ㄊㄕㄍㄔ
憶戀思景=ㄧㄌㄙㄐ
你愛我嗎=ㄋㄞㄨㄇ
勇敢去愛=ㄩㄍㄑㄞ
你怕不怕失去我(純伴奏)=ㄋㄆㄅㄆㄕㄑㄨ(ㄔㄅㄗ)
易水寒=ㄧㄕㄏ
自己照顧自己=ㄗㄐㄓㄍㄗㄐ
午夜香吻(純伴奏)=ㄨㄧㄒㄨ(ㄔㄅㄗ)
我甘願=ㄨㄍㄩ
蘇慧倫,成龍=ㄙㄏㄌ,ㄔㄌ
化蝶飛=ㄏㄉㄈ
永遠不回頭=ㄩㄩㄅㄏㄊ
愛中相遇=ㄞㄓㄒㄩ
盧學叡=ㄌㄒㄖ
望你疼惜(純伴奏)=ㄨㄋㄊㄒ(ㄔㄅㄗ)
妖怪手錶=ㄧㄍㄕㄅ
爸爸超人=ㄅㄅㄔㄖ
梅雨季節=ㄇㄩㄐㄐ
情網(純伴奏)=ㄑㄨ(ㄔㄅㄗ)
透明玫瑰=ㄊㄇㄇㄍ
春天花會開=ㄔㄊㄏㄏㄎ
無愛卡快活=ㄨㄞㄎㄎㄏ
最後的戰役=ㄗㄏㄉㄓㄧ
陷阱=ㄒㄐ
買辣椒也用券=ㄇㄌㄐㄧㄩㄑ
說說話=ㄕㄕㄏ
逆光(純伴奏)=ㄋㄍ(ㄔㄅㄗ)
無言花=ㄨㄧㄏ
杜德偉=ㄉㄉㄨ
誰能禁止我的愛=ㄕㄋㄐㄓㄨㄉㄞ
情人(純伴奏)=ㄑㄖ(ㄔㄅㄗ)
黃昏孤燈=ㄏㄏㄍㄉ
聖誕夜驚魂=ㄕㄉㄧㄐㄏ
愛上了一條街=ㄞㄕㄌㄧㄊㄐ
愛與折磨=ㄞㄩㄓㄇ
蘇煒喬=ㄙㄨㄑ
許慧欣=ㄒㄏㄒ
十年(純伴奏)=ㄕㄋ(ㄔㄅㄗ)
泳兒=ㄩㄦ
愛我的資格=ㄞㄨㄉㄗㄍ
怨蒼天變了心=ㄩㄘㄊㄅㄌㄒ
李千那,李李仁=ㄌㄑㄋ,ㄌㄌㄖ
誰人甲我比(純伴奏)=ㄕㄖㄐㄨㄅ(ㄔㄅㄗ)
扭扭體操=ㄋㄋㄊㄘ
低等動物=ㄉㄉㄉㄨ
養我一輩子=ㄧㄨㄧㄅㄗ
一個人的對話=ㄧㄍㄖㄉㄉㄏ
終於愛情=ㄓㄩㄞㄑ
站在高崗上=ㄓㄗㄍㄍㄕ
愛在夕陽下=ㄞㄗㄒㄧㄒ
船上的小姐=ㄔㄕㄉㄒㄐ
怪怪牌=ㄍㄍㄆ
安心亞=ㄢㄒㄧ
音闕詩聽,小魂=ㄧㄑㄕㄊ,ㄒㄏ
慢慢=ㄇㄇ
裝聾作啞=ㄓㄌㄗㄧ
過客(純伴奏)=ㄍㄎ(ㄔㄅㄗ)
遲來的愛=ㄔㄌㄉㄞ
王嘉爾,=ㄨㄐㄦ,
你看你看月亮的臉(新版)=ㄋㄎㄋㄎㄩㄌㄉㄌ(ㄒㄅ)
你連笑起來都不快樂=ㄋㄌㄒㄑㄌㄉㄅㄎㄌ
一碗麵=ㄧㄨㄇ
好想你(純伴奏)=ㄏㄒㄋ(ㄔㄅㄗ)
我不難過(純伴奏)=ㄨㄅㄋㄍ(ㄔㄅㄗ)
韋禮安=ㄨㄌㄢ
馬靚辳=ㄇㄐ辳
承諾=ㄔㄋ
榮美的救主=ㄖㄇㄉㄐㄓ
背著你=ㄅㄓㄋ
隱形的翅膀(純伴奏)=ㄧㄒㄉㄔㄅ(ㄔㄅㄗ)
心聲淚=ㄒㄕㄌ
髭男=ㄗㄋ
茫茫到深更(純伴奏)=ㄇㄇㄉㄕㄐ(ㄔㄅㄗ)
兩個人的月亮=ㄌㄍㄖㄉㄩㄌ
我們的探險計劃=ㄨㄇㄉㄊㄒㄐㄏ
蔡義德=ㄘㄧㄉ
歲月神偷(純伴奏)=ㄙㄩㄕㄊ(ㄔㄅㄗ)
友情歲月=ㄧㄑㄙㄩ
別說沒愛過=ㄅㄕㄇㄞㄍ
相思雨=ㄒㄙㄩ
你不是真正的快樂=ㄋㄅㄕㄓㄓㄉㄎㄌ
謝宜君=ㄒㄧㄐ
說了再見(純伴奏)=ㄕㄌㄗㄐ(ㄔㄅㄗ)
一綾=ㄧㄌ
進退攏為難=ㄐㄊㄌㄨㄋ
一場遊戲一場夢(純伴奏)=ㄧㄔㄧㄒㄧㄔㄇ(ㄔㄅㄗ)
抬起我的頭=ㄊㄑㄨㄉㄊ
豆豆龍=ㄉㄉㄌ
王大文陳芳語=ㄨㄉㄨㄔㄈㄩ
一簾幽夢=ㄧㄌㄧㄇ
翁立友,許芷芸=ㄨㄌㄧ,ㄒㄓㄩ
小小孩=ㄒㄒㄏ
柔=ㄖ
哥抽菸=ㄍㄔㄧ
回味(純伴奏)=ㄏㄨ(ㄔㄅㄗ)
我終於失去了你=ㄨㄓㄩㄕㄑㄌㄋ
戒指=ㄐㄓ
若你碰到他(純伴奏)=ㄖㄋㄆㄉㄊ(ㄔㄅㄗ)
愛錯=ㄞㄘ
慕靈=ㄇㄌ
那個靜默的陽光午後=ㄋㄍㄐㄇㄉㄧㄍㄨㄏ
女人心=ㄋㄖㄒ
又是秋天=ㄧㄕㄑㄊ
羅時豐,王瑞霞=ㄌㄕㄈ,ㄨㄖㄒ
什麼,哪裡=ㄕㄇ,ㄋㄌ
水手=ㄕㄕ
還是要幸福=ㄏㄕㄧㄒㄈ
心愛的甭哭(純伴奏)=ㄒㄞㄉㄅㄎ(ㄔㄅㄗ)
人在雨中=ㄖㄗㄩㄓ
老情歌=ㄌㄑㄍ
天下皆醉我獨醒=ㄊㄒㄐㄗㄨㄉㄒ
洪榮宏,曹雅雯=ㄏㄖㄏ,ㄘㄧㄨ
送行=ㄙㄒ
多想在平庸的生活擁抱你=ㄉㄒㄗㄆㄩㄉㄕㄏㄩㄅㄋ
是阮(純伴奏)=ㄕㄖ(ㄔㄅㄗ)
無名之輩(純伴奏)=ㄨㄇㄓㄅ(ㄔㄅㄗ)
心狠手辣=ㄒㄏㄕㄌ
女人說(純伴奏)=ㄋㄖㄕ(ㄔㄅㄗ)
多情人都把靈魂給了誰=ㄉㄑㄖㄉㄅㄌㄏㄍㄌㄕ
聽不到=ㄊㄅㄉ
南屏晚鐘(純伴奏)=ㄋㄆㄨㄓ(ㄔㄅㄗ)
作曲家=ㄗㄑㄐ
牽手=ㄑㄕ
愛我到今生=ㄞㄨㄉㄐㄕ
幾分傷心幾分痴=ㄐㄈㄕㄒㄐㄈㄔ
你像個孩子=ㄋㄒㄍㄏㄗ
鄧麗欣方力申=ㄉㄌㄒㄈㄌㄕ
夢醒心碎=ㄇㄒㄒㄙ
愛甲這呢雄=ㄞㄐㄓㄋㄒ
沒有你陪伴真的好孤單(純伴奏)=ㄇㄧㄋㄆㄅㄓㄉㄏㄍㄉ(ㄔㄅㄗ)
晴愔=ㄑㄧ
金佩姍=ㄐㄆㄒ
頭仔=ㄊㄗ
忘不記=ㄨㄅㄐ
車站惜別(純伴奏)=ㄔㄓㄒㄅ(ㄔㄅㄗ)
心情車站=ㄒㄑㄔㄓ
點不著的番仔火=ㄉㄅㄓㄉㄈㄗㄏ
回想曲(純伴奏)=ㄏㄒㄑ(ㄔㄅㄗ)
呂薔=ㄌㄑ
我愛你那麼多=ㄨㄞㄋㄋㄇㄉ
迷湯=ㄇㄊ
煞到妳=ㄕㄉㄋ
慢慢等=ㄇㄇㄉ
錯過你錯過愛=ㄘㄍㄋㄘㄍㄞ
般若波羅蜜多心經=ㄅㄖㄆㄌㄇㄉㄒㄐ
大支=ㄉㄓ
天天天藍=ㄊㄊㄊㄌ
無窮(純伴奏)=ㄨㄑ(ㄔㄅㄗ)
全世界的孤單=ㄑㄕㄐㄉㄍㄉ
他夏了夏天=ㄊㄒㄌㄒㄊ
天黑=ㄊㄏ
范瑋琪=ㄈㄨㄑ
永遠的第一天=ㄩㄩㄉㄉㄧㄊ
忘情果=ㄨㄑㄍ
自虐=ㄗㄋ
下輩子別再做女人=ㄒㄅㄗㄅㄗㄗㄋㄖ
陳隨意=ㄔㄙㄧ
你是不是有點動心=ㄋㄕㄅㄕㄧㄉㄉㄒ
對愛渴望(純伴奏)=ㄉㄞㄎㄨ(ㄔㄅㄗ)
這款自作多情=ㄓㄎㄗㄗㄉㄑ
王力宏,譚維維=ㄨㄌㄏ,ㄊㄨㄨ
易燃易爆炸=ㄧㄖㄧㄅㄓ
厚臉皮=ㄏㄌㄆ
終於勇敢了(純伴奏)=ㄓㄩㄩㄍㄌ(ㄔㄅㄗ)
來自天堂的魔鬼(純伴奏)=ㄌㄗㄊㄊㄉㄇㄍ(ㄔㄅㄗ)
孤單消防員=ㄍㄉㄒㄈㄩ
十年如當日=ㄕㄋㄖㄉㄖ
放蕩不羈=ㄈㄉㄅㄐ
虛擬=ㄒㄋ
徐懷鈺=ㄒㄏㄩ
桑田佳祐=ㄙㄊㄐㄧ
笑著回家(純伴奏)=ㄒㄓㄏㄐ(ㄔㄅㄗ)
那些你很冒險的夢(純伴奏)=ㄋㄒㄋㄏㄇㄒㄉㄇ(ㄔㄅㄗ)
再問一次=ㄗㄨㄧㄘ
想念你的夜=ㄒㄋㄋㄉㄧ
愛愈深傷愈重=ㄞㄩㄕㄕㄩㄔ
變幻的年代=ㄅㄏㄉㄋㄉ
讓我得見祢的榮面=ㄖㄨㄉㄐㄋㄉㄖㄇ
最愛是你=ㄗㄞㄕㄋ
彼岸花=ㄅㄢㄏ
窗外=ㄔㄨ
是否=ㄕㄈ
回鄉的囝仔=ㄏㄒㄉㄋㄗ
王菀之=ㄨㄨㄓ
心內話=ㄒㄋㄏ
放捨你我心嘸甘=ㄈㄕㄋㄨㄒㄈㄍ
不必在乎我是誰=ㄅㄅㄗㄏㄨㄕㄕ
布仁巴雅爾=ㄅㄖㄅㄧㄦ
伴阮過一生=ㄅㄖㄍㄧㄕ
又不是這樣就不孤獨=ㄧㄅㄕㄓㄧㄐㄅㄍㄉ
麥小兜=ㄇㄒㄉ
無與倫比的美麗=ㄨㄩㄌㄅㄉㄇㄌ
好好=ㄏㄏ
這不是我(純伴奏)=ㄓㄅㄕㄨ(ㄔㄅㄗ)
李心潔=ㄌㄒㄐ
燕子=ㄧㄗ
西北雨直直落=ㄒㄅㄩㄓㄓㄌ
蔡佩軒=ㄘㄆㄒ
很需要=ㄏㄒㄧ
我心已打烊(純伴奏)=ㄨㄒㄧㄉㄧ(ㄔㄅㄗ)
那個我=ㄋㄍㄨ
想要跟你飛(純伴奏)=ㄒㄧㄍㄋㄈ(ㄔㄅㄗ)
別戀=ㄅㄌ
陳昊森=ㄔㄏㄙ
風一樣的男子=ㄈㄧㄧㄉㄋㄗ
起飛=ㄑㄈ
雙棲動物=ㄕㄑㄉㄨ
沒關係=ㄇㄍㄒ
靠岸=ㄎㄢ
玫瑰花瓣的信箋(純伴奏)=ㄇㄍㄏㄅㄉㄒㄐ(ㄔㄅㄗ)
帶我離開=ㄉㄨㄌㄎ
港都的月=ㄍㄉㄉㄩ
聖靈的江河=ㄕㄌㄉㄐㄏ
糯米糰=ㄋㄇㄊ
花心(純伴奏)=ㄏㄒ(ㄔㄅㄗ)
遠行=ㄩㄒ
李宗盛=ㄌㄗㄕ
野摩托=ㄧㄇㄊ
詹曼鈴,李明洋=ㄓㄇㄌ,ㄌㄇㄧ
二十四小時柒天=ㄦㄕㄙㄒㄕㄑㄊ
很愛=ㄏㄞ
對愛期待=ㄉㄞㄑㄉ
葉蒨文=ㄧㄑㄨ
媽媽的背影=ㄇㄇㄉㄅㄧ
楊宗緯張碧晨=ㄧㄗㄨㄓㄅㄔ
盧巧音,王力宏=ㄌㄑㄧ,ㄨㄌㄏ
成鳳=ㄔㄈ
還在夏天呢=ㄏㄗㄒㄊㄋ
枕邊人(純伴奏)=ㄓㄅㄖ(ㄔㄅㄗ)
你說愛,然後呢=ㄋㄕㄞ,ㄖㄏㄋ
我怎能離開你=ㄨㄗㄋㄌㄎㄋ
何維健=ㄏㄨㄐ
請擁抱我=ㄑㄩㄅㄨ
童話(純伴奏)=ㄊㄏ(ㄔㄅㄗ)
失落沙洲=ㄕㄌㄕㄓ
愛因斯坦(純伴奏)=ㄞㄧㄙㄊ(ㄔㄅㄗ)
愛情的模樣=ㄞㄑㄉㄇㄧ
威尼斯的淚=ㄨㄋㄙㄉㄌ
吳若希=ㄨㄖㄒ
莊振凱,戴梅君=ㄓㄓㄎ,ㄉㄇㄐ
過客=ㄍㄎ
該死的溫柔(純伴奏)=ㄍㄙㄉㄨㄖ(ㄔㄅㄗ)
說好不哭(純伴奏)=ㄕㄏㄅㄎ(ㄔㄅㄗ)
不曾回來過(純伴奏)=ㄅㄘㄏㄌㄍ(ㄔㄅㄗ)
還是會寂寞=ㄏㄕㄏㄐㄇ
胡楊林=ㄏㄧㄌ
謝謝妳愛我(純伴奏)=ㄒㄒㄋㄞㄨ(ㄔㄅㄗ)
沒有情人的情人節=ㄇㄧㄑㄖㄉㄑㄖㄐ
生命中的精靈=ㄕㄇㄓㄉㄐㄌ
戀愛達人=ㄌㄞㄉㄖ
過得去=ㄍㄉㄑ
你甘有愛過我=ㄋㄍㄧㄞㄍㄨ
稻草人=ㄉㄘㄖ
小心肝=ㄒㄒㄍ
來個蹦蹦=ㄌㄍㄅㄅ
飛兒樂團,信=ㄈㄦㄩㄊ,ㄒ
莊振凱=ㄓㄓㄎ
田亞霍=ㄊㄧㄏ
為愛痴狂=ㄨㄞㄔㄎ
人生證明=ㄖㄕㄓㄇ
勾啊勾手指=ㄍㄚㄍㄕㄓ
倔強=ㄐㄐ
女人香=ㄋㄖㄒ
殷悅=ㄧㄩ
只愛你一個=ㄓㄞㄋㄧㄍ
走不出的回憶=ㄗㄅㄔㄉㄏㄧ
罪惡感=ㄗㄨㄍ
新鮮=ㄒㄒ
陳慧嫻=ㄔㄏㄒ
今天不回家(純伴奏)=ㄐㄊㄅㄏㄐ(ㄔㄅㄗ)
白櫻=ㄅㄧ
甜美的繩索=ㄊㄇㄉㄕㄙ
流浪找頭路=ㄌㄌㄓㄊㄌ
紀家盈=ㄐㄐㄧ
祢是彌賽亞=ㄋㄕㄇㄙㄧ
梯田=ㄊㄊ
屁孩,水水=ㄆㄏ,ㄕㄕ
我想有個家=ㄨㄒㄧㄍㄐ
五月天,蕭敬騰=ㄨㄩㄊ,ㄒㄐㄊ
王以太=ㄨㄧㄊ
別讓我走遠=ㄅㄖㄨㄗㄩ
說過的不算=ㄕㄍㄉㄅㄙ
天高地厚(純伴奏)=ㄊㄍㄉㄏ(ㄔㄅㄗ)
閻奕格=ㄧㄧㄍ
蘇運瑩=ㄙㄩㄧ
戰利品=ㄓㄌㄆ
容易受傷的女人(純伴奏)=ㄖㄧㄕㄕㄉㄋㄖ(ㄔㄅㄗ)
張蓉蓉,楊哲=ㄓㄖㄖ,ㄧㄓ
紅豆=ㄏㄉ
你瞞我瞞=ㄋㄇㄨㄇ
男傭=ㄋㄩ
燒酒斟雙杯=ㄕㄐㄓㄕㄅ
囚鳥=ㄑㄋ
家族=ㄐㄗ
雪人=ㄒㄖ
我想要說=ㄨㄒㄧㄕ
遺失的美好=ㄧㄕㄉㄇㄏ
堅強的女性=ㄐㄑㄉㄋㄒ
紫薇=ㄗㄨ
你愛永不變=ㄋㄞㄩㄅㄅ
公主病=ㄍㄓㄅ
就是現在=ㄐㄕㄒㄗ
酒女夢(純伴奏)=ㄐㄋㄇ(ㄔㄅㄗ)
我還是不懂=ㄨㄏㄕㄅㄉ
乾一杯=ㄍㄧㄅ
不存在的情人=ㄅㄘㄗㄉㄑㄖ
許仁杰=ㄒㄖㄐ
護情符=ㄏㄑㄈ
春花望露水=ㄔㄏㄨㄌㄕ
且行且珍惜=ㄑㄒㄑㄓㄒ
原來=ㄩㄌ
小婚禮=ㄒㄏㄌ
相愛後動物感傷=ㄒㄞㄏㄉㄨㄍㄕ
其實我們值得幸福=ㄑㄕㄨㄇㄓㄉㄒㄈ
是我不夠好(純伴奏)=ㄕㄨㄅㄍㄏ(ㄔㄅㄗ)
親愛你=ㄑㄞㄋ
兩腳書櫥的逃亡=ㄌㄐㄕㄔㄉㄊㄨ
我們不像我們=ㄨㄇㄅㄒㄨㄇ
我愛妳不會改變=ㄨㄞㄋㄅㄏㄍㄅ
左手指月(純伴奏)=ㄗㄕㄓㄩ(ㄔㄅㄗ)
暴風雪=ㄅㄈㄒ
被風吹過的夏天=ㄅㄈㄔㄍㄉㄒㄊ
露珠兒=ㄌㄓㄦ
癡情月娘島(純伴奏)=ㄔㄑㄩㄋㄉ(ㄔㄅㄗ)
我的天=ㄨㄉㄊ
紙短情長(純伴奏)=ㄓㄉㄑㄔ(ㄔㄅㄗ)
沒有妳的我=ㄇㄧㄋㄉㄨ
何潤東=ㄏㄖㄉ
張秀卿=ㄓㄒㄑ
牽牽牽手=ㄑㄑㄑㄕ
愛瘋了=ㄞㄈㄌ
汪東城,蔡旻佑,曾沛慈=ㄨㄉㄔ,ㄘㄇㄧ,ㄘㄆㄘ
痴戀的一生=ㄔㄌㄉㄧㄕ
小賴=ㄒㄌ
笑到流淚=ㄒㄉㄌㄌ
抹凍愛的人=ㄇㄉㄞㄉㄖ
當=ㄉ
我的失敗與偉大=ㄨㄉㄕㄅㄩㄨㄉ
飛行部落=ㄈㄒㄅㄌ
薄荷=ㄅㄏ
你是如此難以忘記=ㄋㄕㄖㄘㄋㄧㄨㄐ
永遠相信=ㄩㄩㄒㄒ
我的小妹=ㄨㄉㄒㄇ
邱澤=ㄑㄗ
旋轉門=ㄒㄓㄇ
(現在就是永遠)=(ㄒㄗㄐㄕㄩㄩ)
我是一隻小小鳥=ㄨㄕㄧㄓㄒㄒㄋ
失落的情=ㄕㄌㄉㄑ
愛情真偉大=ㄞㄑㄓㄨㄉ
說好的幸福呢=ㄕㄏㄉㄒㄈㄋ
為愛而生=ㄨㄞㄦㄕ
逍遙年代=ㄒㄧㄋㄉ
尖叫聲=ㄐㄐㄕ
剛剛好(純伴奏)=ㄍㄍㄏ(ㄔㄅㄗ)
左耳=ㄗㄦ
吳克群鍾欣桐=ㄨㄎㄑㄓㄒㄊ
捨不得讓你走=ㄕㄅㄉㄖㄋㄗ
好膽你就來=ㄏㄉㄋㄐㄌ
刻在我心底的名字=ㄎㄗㄨㄒㄉㄉㄇㄗ
大悲咒=ㄉㄅㄓ
愛戀魔法=ㄞㄌㄇㄈ
逆風飛翔(純伴奏)=ㄋㄈㄈㄒ(ㄔㄅㄗ)
又擱想起你=ㄧㄍㄒㄑㄋ
三心兩意=ㄙㄒㄌㄧ
家後(純伴奏)=ㄐㄏ(ㄔㄅㄗ)
很受傷=ㄏㄕㄕ
梁靜茹,張智成=ㄌㄐㄖ,ㄓㄓㄔ
金剛圈=ㄐㄍㄑ
修煉愛情=ㄒㄌㄞㄑ
那些年(純伴奏)=ㄋㄒㄋ(ㄔㄅㄗ)
這就是愛嗎(純伴奏)=ㄓㄐㄕㄞㄇ(ㄔㄅㄗ)
一見你就笑(純伴奏)=ㄧㄐㄋㄐㄒ(ㄔㄅㄗ)
他舉起右手點名=ㄊㄐㄑㄧㄕㄉㄇ
龔詩嘉=ㄍㄕㄐ
煎熬=ㄐㄠ
溫暖的祝福=ㄨㄋㄉㄓㄈ
我好想好想你=ㄨㄏㄒㄏㄒㄋ
朱碧石=ㄓㄅㄕ
已經=ㄧㄐ
虎姑婆(純伴奏)=ㄏㄍㄆ(ㄔㄅㄗ)
何苦=ㄏㄎ
不期而遇=ㄅㄑㄦㄩ
藤原浩=ㄊㄩㄏ
愛作夢的魚=ㄞㄗㄇㄉㄩ
幾分之幾=ㄐㄈㄓㄐ
五月天,吳宗憲=ㄨㄩㄊ,ㄨㄗㄒ
天上的男人地上的女人=ㄊㄕㄉㄋㄖㄉㄕㄉㄋㄖ
不許人佔有=ㄅㄒㄖㄓㄧ
我不懂愛=ㄨㄅㄉㄞ
斯芬克斯=ㄙㄈㄎㄙ
一百萬個可能(純伴奏)=ㄧㄅㄨㄍㄎㄋ(ㄔㄅㄗ)
布拉格廣場=ㄅㄌㄍㄍㄔ
銀臨=ㄧㄌ
與浪之間=ㄩㄌㄓㄐ
從未到過的地方(純伴奏)=ㄘㄨㄉㄍㄉㄉㄈ(ㄔㄅㄗ)
別說=ㄅㄕ
七十億分之一=ㄑㄕㄧㄈㄓㄧ
羅志祥=ㄌㄓㄒ
次心動=ㄘㄒㄉ
愛如潮水=ㄞㄖㄔㄕ
周杰倫,楊瑞代=ㄓㄐㄌ,ㄧㄖㄉ
鎖上記憶=ㄙㄕㄐㄧ
這就是愛=ㄓㄐㄕㄞ
魏嘉瑩=ㄨㄐㄧ
半島鐵盒=ㄅㄉㄊㄏ
陳一郎=ㄔㄧㄌ
生存以上生活以下=ㄕㄘㄧㄕㄕㄏㄧㄒ
有你的快樂=ㄧㄋㄉㄎㄌ
長生訣=ㄔㄕㄐ
可惜不是你=ㄎㄒㄅㄕㄋ
吳克群莫安琪=ㄨㄎㄑㄇㄢㄑ
癡情拿鐵=ㄔㄑㄋㄊ
靠站=ㄎㄓ
阿吉仔,吳儀君=ㄚㄐㄗ,ㄨㄧㄐ
痴心絕對=ㄔㄒㄐㄉ
大穎=ㄉㄧ
人形の家=ㄖㄒのㄐ
飛向你飛向我(純伴奏)=ㄈㄒㄋㄈㄒㄨ(ㄔㄅㄗ)
男性的本領=ㄋㄒㄉㄅㄌ
人間煙火=ㄖㄐㄧㄏ
世界末日=ㄕㄐㄇㄖ
方瑞娥傑克=ㄈㄖㄜㄐㄎ
曹雅雯=ㄘㄧㄨ
遊山戀=ㄧㄕㄌ
烏咕咕=ㄨㄍㄍ
繁花=ㄈㄏ
分=ㄈ
生祥樂隊=ㄕㄒㄩㄉ
觀眾=ㄍㄓ
笨蛋=ㄅㄉ
人生是一條河=ㄖㄕㄕㄧㄊㄏ
什麼歌=ㄕㄇㄍ
擁抱(純伴奏)=ㄩㄅ(ㄔㄅㄗ)
道聽塗說=ㄉㄊㄊㄕ
崔苔菁=ㄘㄊㄐ
隱形去看你=ㄧㄒㄑㄎㄋ
紙雨傘(純伴奏)=ㄓㄩㄙ(ㄔㄅㄗ)
至少還有我=ㄓㄕㄏㄧㄨ
預言=ㄩㄧ
天上的家=ㄊㄕㄉㄐ
你要的愛=ㄋㄧㄉㄞ
甜蜜的枕頭=ㄊㄇㄉㄓㄊ
一切安好=ㄧㄑㄢㄏ
王瑞霞=ㄨㄖㄒ
歸屬感=ㄍㄕㄍ
玫瑰心浪子情=ㄇㄍㄒㄌㄗㄑ
我要快樂=ㄨㄧㄎㄌ
專家模式=ㄓㄐㄇㄕ
巧合=ㄑㄏ
大家利事=ㄉㄐㄌㄕ
心痛=ㄒㄊ
徐佳瑩=ㄒㄐㄧ
我的唇吻不到我愛的人=ㄨㄉㄔㄨㄅㄉㄨㄞㄉㄖ
原來只要共你活一天(純伴奏)=ㄩㄌㄓㄧㄍㄋㄏㄧㄊ(ㄔㄅㄗ)
新生命小組教會敬拜團=ㄒㄕㄇㄒㄗㄐㄏㄐㄅㄊ
愛上你=ㄞㄕㄋ
容祖兒=ㄖㄗㄦ
如果我們不曾相遇=ㄖㄍㄨㄇㄅㄘㄒㄩ
唱這歌=ㄔㄓㄍ
我們不是永遠都那麼勇敢=ㄨㄇㄅㄕㄩㄩㄉㄋㄇㄩㄍ
翩翩飛起=ㄆㄆㄈㄑ
我一個人住=ㄨㄧㄍㄖㄓ
當你=ㄉㄋ
林俊傑,鄧紫棋=ㄌㄐㄐ,ㄉㄗㄑ
上上籤=ㄕㄕㄑ
一點點=ㄧㄉㄉ
空港=ㄎㄍ
娛樂天空=ㄩㄌㄊㄎ
怨偶(純伴奏)=ㄩㄡ(ㄔㄅㄗ)
天越亮,夜越黑=ㄊㄩㄌ,ㄧㄩㄏ
來去台東(純伴奏)=ㄌㄑㄊㄉ(ㄔㄅㄗ)
英台=ㄧㄊ
真愛無價=ㄓㄞㄨㄐ
四百龍銀=ㄙㄅㄌㄧ
大壯=ㄉㄓ
一個人還是想著一個人=ㄧㄍㄖㄏㄕㄒㄓㄧㄍㄖ
金瑞瑤=ㄐㄖㄧ
愛過你有多久就有多痛(純伴奏)=ㄞㄍㄋㄧㄉㄐㄐㄧㄉㄊ(ㄔㄅㄗ)
沿海地帶=ㄧㄏㄉㄉ
親愛的你在哪裡(純伴奏)=ㄑㄞㄉㄋㄗㄋㄌ(ㄔㄅㄗ)
愛情嘸是人生的一切=ㄞㄑㄈㄕㄖㄕㄉㄧㄑ
你最珍貴(純伴奏)=ㄋㄗㄓㄍ(ㄔㄅㄗ)
浪費(純伴奏)=ㄌㄈ(ㄔㄅㄗ)
橋邊姑娘=ㄑㄅㄍㄋ
不是男人=ㄅㄕㄋㄖ
時光機=ㄕㄍㄐ
似水年華=ㄙㄕㄋㄏ
盛夏光年=ㄕㄒㄍㄋ
好在=ㄏㄗ
風衣=ㄈㄧ
真心疼惜你=ㄓㄒㄊㄒㄋ
單身潛逃=ㄉㄕㄑㄊ
甜蜜蜜=ㄊㄇㄇ
小咪=ㄒㄇ
獨一無二=ㄉㄧㄨㄦ
黎明=ㄌㄇ
失憶的金魚(純伴奏)=ㄕㄧㄉㄐㄩ(ㄔㄅㄗ)
愛不需要裝乖=ㄞㄅㄒㄧㄓㄍ
相對的失去=ㄒㄉㄉㄕㄑ
真心誤會=ㄓㄒㄨㄏ
告別像低迴溫婉的小調=ㄍㄅㄒㄉㄏㄨㄨㄉㄒㄉ
念舊=ㄋㄐ
范瑋琪,王宏恩=ㄈㄨㄑ,ㄨㄏㄣ
返來阮身邊=ㄈㄌㄖㄕㄅ
邊緣朋友=ㄅㄩㄆㄧ
她的眼淚=ㄊㄉㄧㄌ
毋願=ㄨㄩ
我不是你想像那麼勇敢(純伴奏)=ㄨㄅㄕㄋㄒㄒㄋㄇㄩㄍ(ㄔㄅㄗ)
解脫=ㄐㄊ
自己的房間=ㄗㄐㄉㄈㄐ
不快樂=ㄅㄎㄌ
做你的貓=ㄗㄋㄉㄇ
飆汗(純伴奏)=ㄅㄏ(ㄔㄅㄗ)
忘課=ㄨㄎ
撕夜(純伴奏)=ㄙㄧ(ㄔㄅㄗ)
來個蹦蹦(純伴奏)=ㄌㄍㄅㄅ(ㄔㄅㄗ)
漂泊風聲=ㄆㄅㄈㄕ
愛我别走=ㄞㄨ别ㄗ
放不下=ㄈㄅㄒ
懷念的播音員(純伴奏)=ㄏㄋㄉㄅㄧㄩ(ㄔㄅㄗ)
愛我的人和我愛的人=ㄞㄨㄉㄖㄏㄨㄞㄉㄖ
安九=ㄢㄐ
我們會再見=ㄨㄇㄏㄗㄐ
講真的=ㄐㄓㄉ
我不願讓你一個人(純伴奏)=ㄨㄅㄩㄖㄋㄧㄍㄖ(ㄔㄅㄗ)
戴愛玲=ㄉㄞㄌ
奔向未來日子精密=ㄅㄒㄨㄌㄖㄗㄐㄇ
我愛妳彭拉昆=ㄨㄞㄋㄆㄌㄎ
只要再看你一眼(純伴奏)=ㄓㄧㄗㄎㄋㄧㄧ(ㄔㄅㄗ)
算你狠=ㄙㄋㄏ
薛之謙=ㄒㄓㄑ
只愛你一個(純伴奏)=ㄓㄞㄋㄧㄍ(ㄔㄅㄗ)
野獸=ㄧㄕ
鑽石=ㄗㄕ
可可托海的牧羊人=ㄎㄎㄊㄏㄉㄇㄧㄖ
倒數(純伴奏)=ㄉㄕ(ㄔㄅㄗ)
永遠的畫面=ㄩㄩㄉㄏㄇ
白安=ㄅㄢ
桃花諾=ㄊㄏㄋ
唸你=ㄋㄋ
一起吃苦的幸福=ㄧㄑㄔㄎㄉㄒㄈ
跟著感覺走(純伴奏)=ㄍㄓㄍㄐㄗ(ㄔㄅㄗ)
姜育恆=ㄐㄩㄏ
哭過的天空=ㄎㄍㄉㄊㄎ
護花使者=ㄏㄏㄕㄓ
對面的女孩看過來=ㄉㄇㄉㄋㄏㄎㄍㄌ
微光中的歌吟=ㄨㄍㄓㄉㄍㄧ
癡情紅玫瑰=ㄔㄑㄏㄇㄍ
小時姑娘=ㄒㄕㄍㄋ
周傳雄=ㄓㄔㄒ
下個星期去英國=ㄒㄍㄒㄑㄑㄧㄍ
乾杯萬萬歲=ㄍㄅㄨㄨㄙ
半斤八兩=ㄅㄐㄅㄌ
情路走到這=ㄑㄌㄗㄉㄓ
非你不可=ㄈㄋㄅㄎ
一想到你呀=ㄧㄒㄉㄋㄧ
遇見幸福三百天=ㄩㄐㄒㄈㄙㄅㄊ
草蜢=ㄘㄇ
周璇=ㄓㄒ
洪安妮=ㄏㄢㄋ
你好不好=ㄋㄏㄅㄏ
總有一個人=ㄗㄧㄧㄍㄖ
千年萬年=ㄑㄋㄨㄋ
讓我好好看看你=ㄖㄨㄏㄏㄎㄎㄋ
真的傻=ㄓㄉㄕ
愛瘋頭=ㄞㄈㄊ
星月(純伴奏)=ㄒㄩ(ㄔㄅㄗ)
這該死的愛=ㄓㄍㄙㄉㄞ
我最愛的人就是你(純伴奏)=ㄨㄗㄞㄉㄖㄐㄕㄋ(ㄔㄅㄗ)
預感=ㄩㄍ
離開地球表面=ㄌㄎㄉㄑㄅㄇ
緣分一道橋=ㄩㄈㄧㄉㄑ
矛盾=ㄇㄉ
鄭宜農,陳嫺靜=ㄓㄧㄋ,ㄔㄒㄐ
沢田研二=沢ㄊㄧㄦ
伍佰,=ㄨㄅ,
一天一點愛戀=ㄧㄊㄧㄉㄞㄌ
六哲=ㄌㄓ
一起搖擺吧=ㄧㄑㄧㄅㄅ
林憶蓮,李宗盛=ㄌㄧㄌ,ㄌㄗㄕ
詩篇篇=ㄕㄆㄆ
心之火(純伴奏)=ㄒㄓㄏ(ㄔㄅㄗ)
告白氣球(純伴奏)=ㄍㄅㄑㄑ(ㄔㄅㄗ)
鄭人文=ㄓㄖㄨ
你在ㄍㄧㄥ什麼=ㄋㄗㄍㄧㄥㄕㄇ
喜歡你(純伴奏)=ㄒㄏㄋ(ㄔㄅㄗ)
感情放一邊=ㄍㄑㄈㄧㄅ
心誠則靈=ㄒㄔㄗㄌ
都怪我=ㄉㄍㄨ
茶包=ㄔㄅ
崔子格=ㄘㄗㄍ
點滴在心頭=ㄉㄉㄗㄒㄊ
就這樣=ㄐㄓㄧ
唐儷,莊振凱=ㄊㄌ,ㄓㄓㄎ
灰色軌跡=ㄏㄙㄍㄐ
紅唇族=ㄏㄔㄗ
最好的朋友=ㄗㄏㄉㄆㄧ
是你\=ㄕㄋ\
玖壹壹,阿聖=ㄐㄧㄧ,ㄚㄕ
沈雁=ㄔㄧ
煙把兒樂隊=ㄧㄅㄦㄩㄉ
情人的黃襯衫=ㄑㄖㄉㄏㄔㄕ
情字恨少年=ㄑㄗㄏㄕㄋ
夢見鐵達尼=ㄇㄐㄊㄉㄋ
你在看我嗎=ㄋㄗㄎㄨㄇ
親子台=ㄑㄗㄊ
還是會=ㄏㄕㄏ
雨蝶(純伴奏)=ㄩㄉ(ㄔㄅㄗ)
美麗舊世界=ㄇㄌㄐㄕㄐ
盛夏光年(純伴奏)=ㄕㄒㄍㄋ(ㄔㄅㄗ)
明明就=ㄇㄇㄐ
我當然是座島嶼=ㄨㄉㄖㄕㄗㄉㄩ
天才兒童=ㄊㄘㄦㄊ
我難過=ㄨㄋㄍ
做你的公主=ㄗㄋㄉㄍㄓ
陳淑芳=ㄔㄕㄈ
全是愛=ㄑㄕㄞ
全世界誰傾聽你=ㄑㄕㄐㄕㄑㄊㄋ
靠著耶穌得勝=ㄎㄓㄧㄙㄉㄕ
江志豐吳申梅=ㄐㄓㄈㄨㄕㄇ
說謊的女人=ㄕㄏㄉㄋㄖ
思念是一種病=ㄙㄋㄕㄧㄓㄅ
比莉=ㄅㄌ
幸福摩天輪=ㄒㄈㄇㄊㄌ
春天的風=ㄔㄊㄉㄈ
聽海(純伴奏)=ㄊㄏ(ㄔㄅㄗ)
彩虹=ㄘㄏ
往事只能回味(純伴奏)=ㄨㄕㄓㄋㄏㄨ(ㄔㄅㄗ)
想見你想見你想見你(純伴奏)=ㄒㄐㄋㄒㄐㄋㄒㄐㄋ(ㄔㄅㄗ)
進階(純伴奏)=ㄐㄐ(ㄔㄅㄗ)
我不是饒舌歌手=ㄨㄅㄕㄖㄕㄍㄕ
直來直往=ㄓㄌㄓㄨ
他不懂=ㄊㄅㄉ
給所有單身女子=ㄍㄙㄧㄉㄕㄋㄗ
全年無休(純伴奏)=ㄑㄋㄨㄒ(ㄔㄅㄗ)
鹿港的花蕊=ㄌㄍㄉㄏㄖ
好春宵=ㄏㄔㄒ
三暝三日=ㄙㄇㄙㄖ
相信=ㄒㄒ
祝我幸福=ㄓㄨㄒㄈ
兩個女孩=ㄌㄍㄋㄏ
水中花=ㄕㄓㄏ
悲傷止步(純伴奏)=ㄅㄕㄓㄅ(ㄔㄅㄗ)
小姐!請妳乎我愛(純伴奏)=ㄒㄐ!ㄑㄋㄏㄨㄞ(ㄔㄅㄗ)
戀人未滿=ㄌㄖㄨㄇ
或是一首歌(純伴奏)=ㄏㄕㄧㄕㄍ(ㄔㄅㄗ)
黑夜不再來=ㄏㄧㄅㄗㄌ
有什麼不敢面對=ㄧㄕㄇㄅㄍㄇㄉ
鬧翻天=ㄋㄈㄊ
下一頁的我=ㄒㄧㄧㄉㄨ
陳隨意,謝宜君=ㄔㄙㄧ,ㄒㄧㄐ
故鄉之戀=ㄍㄒㄓㄌ
浮誇=ㄈㄎ
這天=ㄓㄊ
愛一點=ㄞㄧㄉ
孫悟空=ㄙㄨㄎ
落花流水=ㄌㄏㄌㄕ
朱俐靜,陳勢安=ㄓㄌㄐ,ㄔㄕㄢ
來向耶和華歌唱=ㄌㄒㄧㄏㄏㄍㄔ
一個像夏天一個像秋天=ㄧㄍㄒㄒㄊㄧㄍㄒㄑㄊ
孤單=ㄍㄉ
萬花瞳=ㄨㄏㄊ
董貞=ㄉㄓ
洛客班=ㄌㄎㄅ
畢業生=ㄅㄧㄕ
月滿西樓=ㄩㄇㄒㄌ
蜜雪薇琪=ㄇㄒㄨㄑ
天意=ㄊㄧ
世界只有我們=ㄕㄐㄓㄧㄨㄇ
等你看望你疼=ㄉㄋㄎㄨㄋㄊ
夏天的風=ㄒㄊㄉㄈ
湯茜=ㄊㄑ
消愁=ㄒㄔ
沒那麼簡單(純伴奏)=ㄇㄋㄇㄐㄉ(ㄔㄅㄗ)
荒唐=ㄏㄊ
星期六約會=ㄒㄑㄌㄩㄏ
啦=ㄌ
咱的一生咱的愛=ㄗㄉㄧㄕㄗㄉㄞ
告五人=ㄍㄨㄖ
只要再看你一眼=ㄓㄧㄗㄎㄋㄧㄧ
滿座=ㄇㄗ
裸體早餐=ㄌㄊㄗㄘ
大雨的夜裡=ㄉㄩㄉㄧㄌ
林依晨=ㄌㄧㄔ
不再聯繫=ㄅㄗㄌㄒ
曾雅君=ㄘㄧㄐ
放浪舞者=ㄈㄌㄨㄓ
音闕詩聽,昆玉=ㄧㄑㄕㄊ,ㄎㄩ
意難平(純伴奏)=ㄧㄋㄆ(ㄔㄅㄗ)
人生就是戲(純伴奏)=ㄖㄕㄐㄕㄒ(ㄔㄅㄗ)
洪一峰=ㄏㄧㄈ
飄洋過海來看你=ㄆㄧㄍㄏㄌㄎㄋ
黃齡=ㄏㄌ
葉上輝=ㄧㄕㄏ
分開不是誰不好=ㄈㄎㄅㄕㄕㄅㄏ
溫哥華悲傷一號=ㄨㄍㄏㄅㄕㄧㄏ
收信快樂=ㄕㄒㄎㄌ
讓你更愛我=ㄖㄋㄍㄞㄨ
心空等=ㄒㄎㄉ
過錯=ㄍㄘ
不一定=ㄅㄧㄉ
誰都別吝嗇=ㄕㄉㄅㄌㄙ
行走在茫茫月光的中間=ㄒㄗㄗㄇㄇㄩㄍㄉㄓㄐ
王巨星=ㄨㄐㄒ
方力申=ㄈㄌㄕ
張善為=ㄓㄕㄨ
還有眼淚就好=ㄏㄧㄧㄌㄐㄏ
畢竟深愛過=ㄅㄐㄕㄞㄍ
哭笑不得=ㄎㄒㄅㄉ
失戀事小=ㄕㄌㄕㄒ
相思話(純伴奏)=ㄒㄙㄏ(ㄔㄅㄗ)
蔡依林,安室奈美惠=ㄘㄧㄌ,ㄢㄕㄋㄇㄏ
港邊甘是男性傷心的所在=ㄍㄅㄍㄕㄋㄒㄕㄒㄉㄙㄗ
劉佳=ㄌㄐ
堅持到底=ㄐㄔㄉㄉ
上明=ㄕㄇ
缺=ㄑ
阮的愛=ㄖㄉㄞ
鄭秀文,陳奐仁=ㄓㄒㄨ,ㄔㄏㄖ
周深=ㄓㄕ
摩天動物園(純伴奏)=ㄇㄊㄉㄨㄩ(ㄔㄅㄗ)
無事生非=ㄨㄕㄕㄈ
疼惜阮的心=ㄊㄒㄖㄉㄒ
楊欣樺王中平=ㄧㄒㄏㄨㄓㄆ
迷你裙=ㄇㄋㄑ
走了嗎=ㄗㄌㄇ
我不要=ㄨㄅㄧ
疑心病=ㄧㄒㄅ
再也不要=ㄗㄧㄅㄧ
給未來=ㄍㄨㄌ
寂寞的季節=ㄐㄇㄉㄐㄐ
沒有錯=ㄇㄧㄘ
過火=ㄍㄏ
執著=ㄓㄓ
南都夜曲=ㄋㄉㄧㄑ
恰似你的溫柔=ㄑㄙㄋㄉㄨㄖ
流浪天涯伴吉他=ㄌㄌㄊㄧㄅㄐㄊ
冷雨夜=ㄌㄩㄧ
為你的寂寞唱歌(純伴奏)=ㄨㄋㄉㄐㄇㄔㄍ(ㄔㄅㄗ)
妳是我的花朵=ㄋㄕㄨㄉㄏㄉ
藍色聖誕節=ㄌㄙㄕㄉㄐ
拿走了什麼=ㄋㄗㄌㄕㄇ
小白兔遇上卡布奇諾=ㄒㄅㄊㄩㄕㄎㄅㄑㄋ
時間快轉=ㄕㄐㄎㄓ
護駕=ㄏㄐ
廖俊濤=ㄌㄐㄊ
賴慈泓,孫盛希=ㄌㄘㄏ,ㄙㄕㄒ
女人鞋=ㄋㄖㄒ
白露=ㄅㄌ
郭婷筠=ㄍㄊㄩ
裝醉=ㄓㄗ
賴慈泓=ㄌㄘㄏ
流星=ㄌㄒ
不是我不明白=ㄅㄕㄨㄅㄇㄅ
獨善其身(純伴奏)=ㄉㄕㄑㄕ(ㄔㄅㄗ)
我的唇吻不到我愛的人(純伴奏)=ㄨㄉㄔㄨㄅㄉㄨㄞㄉㄖ(ㄔㄅㄗ)
炙愛=ㄓㄞ
陶喆=ㄊㄓ
千金難買=ㄑㄐㄋㄇ
思念借過=ㄙㄋㄐㄍ
風過雨無停=ㄈㄍㄩㄨㄊ
誰=ㄕ
錦繡二重唱=ㄐㄒㄦㄔㄔ
飛=ㄈ
小薇(純伴奏)=ㄒㄨ(ㄔㄅㄗ)
思念無藥醫=ㄙㄋㄨㄧㄧ
一顆心的距離=ㄧㄎㄒㄉㄐㄌ
新鴛鴦蝴蝶夢=ㄒㄩㄧㄏㄉㄇ
甜甜的=ㄊㄊㄉ
王昭君(純伴奏)=ㄨㄓㄐ(ㄔㄅㄗ)
曹操=ㄘㄘ
倒流=ㄉㄌ
墓仔埔也敢來=ㄇㄗㄆㄧㄍㄌ
青春儉起來放=ㄑㄔㄐㄑㄌㄈ
不免你抱歉=ㄅㄇㄋㄅㄑ
于晴=ㄩㄑ
愛你等於愛自己=ㄞㄋㄉㄩㄞㄗㄐ
我這個人(純伴奏)=ㄨㄓㄍㄖ(ㄔㄅㄗ)
讓我送你花一朵=ㄖㄨㄙㄋㄏㄧㄉ
幸福就是=ㄒㄈㄐㄕ
孤單摩天輪=ㄍㄉㄇㄊㄌ
眉來眼去=ㄇㄌㄧㄑ
瀟灑的走=ㄒㄙㄉㄗ
玫瑰心浪子情(純伴奏)=ㄇㄍㄒㄌㄗㄑ(ㄔㄅㄗ)
冬至=ㄉㄓ
貝多芬與我=ㄅㄉㄈㄩㄨ
方炯嘉=ㄈㄐㄐ
畫沙=ㄏㄕ
床頭夢(純伴奏)=ㄔㄊㄇ(ㄔㄅㄗ)
林俊傑蔡卓妍=ㄌㄐㄐㄘㄓㄧ
不要對他說=ㄅㄧㄉㄊㄕ
原來你也唱過我的歌=ㄩㄌㄋㄧㄔㄍㄨㄉㄍ
愛情陷阱=ㄞㄑㄒㄐ
天天夜夜=ㄊㄊㄧㄧ
身不由己=ㄕㄅㄧㄐ
潘瑋柏,張韶涵=ㄆㄨㄅ,ㄓㄕㄏ
林欣彤=ㄌㄒㄊ
三行情詩=ㄙㄏㄑㄕ
更多充滿=ㄍㄉㄔㄇ
艷火(純伴奏)=ㄧㄏ(ㄔㄅㄗ)
甜蜜約定=ㄊㄇㄩㄉ
莫叫姐姐=ㄇㄐㄐㄐ
人生親像扮電影(純伴奏)=ㄖㄕㄑㄒㄅㄉㄧ(ㄔㄅㄗ)
你快樂嗎=ㄋㄎㄌㄇ
再會中港路=ㄗㄏㄓㄍㄌ
連名帶姓=ㄌㄇㄉㄒ
沒有理由(純伴奏)=ㄇㄧㄌㄧ(ㄔㄅㄗ)
痛徹心扉=ㄊㄔㄒㄈ
山頂的春天(純伴奏)=ㄕㄉㄉㄔㄊ(ㄔㄅㄗ)
舊行李=ㄐㄒㄌ
雨人=ㄩㄖ
田馥甄=ㄊㄈㄓ
念親恩=ㄋㄑㄣ
分開旅行=ㄈㄎㄌㄒ
心碎愛情戲=ㄒㄙㄞㄑㄒ
生生=ㄕㄕ
浮生千山路=ㄈㄕㄑㄕㄌ
真心淚=ㄓㄒㄌ
以父之名=ㄧㄈㄓㄇ
就讓我這樣吧=ㄐㄖㄨㄓㄧㄅ
彩虹(純伴奏)=ㄘㄏ(ㄔㄅㄗ)
屋頂(純伴奏)=ㄨㄉ(ㄔㄅㄗ)
記事本=ㄐㄕㄅ
愛你=ㄞㄋ
跟你趴趴走=ㄍㄋㄆㄆㄗ
陷阱妹=ㄒㄐㄇ
七匹狼=ㄑㄆㄌ
姜玉陽,南宮嘉駿=ㄐㄩㄧ,ㄋㄍㄐㄐ
好朋友只是朋友=ㄏㄆㄧㄓㄕㄆㄧ
都幾歲了=ㄉㄐㄙㄌ
新相信未來(純伴奏)=ㄒㄒㄒㄨㄌ(ㄔㄅㄗ)
月亮警察=ㄩㄌㄐㄔ
音闕詩聽趙方婧=ㄧㄑㄕㄊㄓㄈㄐ
劉力揚=ㄌㄌㄧ
炙愛(純伴奏)=ㄓㄞ(ㄔㄅㄗ)
囝仔=ㄋㄗ
來唱家鄉的歌=ㄌㄔㄐㄒㄉㄍ
卜學亮=ㄅㄒㄌ
手嶌葵=ㄕ嶌ㄎ
不再猶豫=ㄅㄗㄧㄩ
青山=ㄑㄕ
感謝你愛我=ㄍㄒㄋㄞㄨ
你是否曾經偷偷的哭=ㄋㄕㄈㄘㄐㄊㄊㄉㄎ
家太遠了=ㄐㄊㄩㄌ
明道=ㄇㄉ
披星戴月的想你(純伴奏)=ㄆㄒㄉㄩㄉㄒㄋ(ㄔㄅㄗ)
最甜情歌=ㄗㄊㄑㄍ
惜情=ㄒㄑ
你是我的眼(純伴奏)=ㄋㄕㄨㄉㄧ(ㄔㄅㄗ)
離人節=ㄌㄖㄐ
九澤=ㄐㄗ
孫盛希=ㄙㄕㄒ
戒菸(純伴奏)=ㄐㄧ(ㄔㄅㄗ)
小棉襖=ㄒㄇㄠ
不驚行情壞=ㄅㄐㄏㄑㄏ
故鄉=ㄍㄒ
來得及說再見=ㄌㄉㄐㄕㄗㄐ
煙火裡的塵埃=ㄧㄏㄌㄉㄔㄞ
只能想念你=ㄓㄋㄒㄋㄋ
死心了沒有=ㄙㄒㄌㄇㄧ
結巴=ㄐㄅ
分開的常理=ㄈㄎㄉㄔㄌ
舊衫櫥=ㄐㄕㄔ
張學友,許志安,鄭中基=ㄓㄒㄧ,ㄒㄓㄢ,ㄓㄓㄐ
人生啊人生=ㄖㄕㄚㄖㄕ
我是不是你最疼愛的人=ㄨㄕㄅㄕㄋㄗㄊㄞㄉㄖ
港都夜雨=ㄍㄉㄧㄩ
從心合一=ㄘㄒㄏㄧ
爆炸的沉默=ㄅㄓㄉㄔㄇ
我對我=ㄨㄉㄨ
陽光和小雨(純伴奏)=ㄧㄍㄏㄒㄩ(ㄔㄅㄗ)
踮起腳尖愛=ㄉㄑㄐㄐㄞ
半點心=ㄅㄉㄒ
思念行李=ㄙㄋㄒㄌ
三輪車跑得快=ㄙㄌㄔㄆㄉㄎ
遙遠的她=ㄧㄩㄉㄊ
冷火=ㄌㄏ
胡夏=ㄏㄒ
王俊凱=ㄨㄐㄎ
一種感覺=ㄧㄓㄍㄐ
妹=ㄇ
父親=ㄈㄑ
假鬼假怪=ㄐㄍㄐㄍ
夢裡花=ㄇㄌㄏ
走馬=ㄗㄇ
艾美麗愛美麗=ㄞㄇㄌㄞㄇㄌ
你是我的幸福嗎?=ㄋㄕㄨㄉㄒㄈㄇ?
苦酒的探戈=ㄎㄐㄉㄊㄍ
戴愛玲,楊培安=ㄉㄞㄌ,ㄧㄆㄢ
半情歌=ㄅㄑㄍ
對伊放抹落=ㄉㄧㄈㄇㄌ
愛情的主人=ㄞㄑㄉㄓㄖ
參商=ㄕㄕ
(好友已滿)=(ㄏㄧㄧㄇ)
不了情=ㄅㄌㄑ
女人心事(純伴奏)=ㄋㄖㄒㄕ(ㄔㄅㄗ)
我們這裡還有魚=ㄨㄇㄓㄌㄏㄧㄩ
真的傻(純伴奏)=ㄓㄉㄕ(ㄔㄅㄗ)
胡思亂想=ㄏㄙㄌㄒ
當聖靈在我心=ㄉㄕㄌㄗㄨㄒ
美空雲雀=ㄇㄎㄩㄑ
故鄉普悠瑪(純伴奏)=ㄍㄒㄆㄧㄇ(ㄔㄅㄗ)
為你幸福過的我=ㄨㄋㄒㄈㄍㄉㄨ
那年夏天寧靜的海=ㄋㄋㄒㄊㄋㄐㄉㄏ
累了走了散了(純伴奏)=ㄌㄌㄗㄌㄙㄌ(ㄔㄅㄗ)
又下雨了=ㄧㄒㄩㄌ
譚荃中吳明華=ㄊㄑㄓㄨㄇㄏ
潛台詞(純伴奏)=ㄑㄊㄘ(ㄔㄅㄗ)
新相信未來=ㄒㄒㄒㄨㄌ
讓我=ㄖㄨ
野子(純伴奏)=ㄧㄗ(ㄔㄅㄗ)
醜人多作怪=ㄔㄖㄉㄗㄍ
做你去=ㄗㄋㄑ
不是不愛=ㄅㄕㄅㄞ
紅塵來去一場夢=ㄏㄔㄌㄑㄧㄔㄇ
濁水溪公社=ㄓㄕㄒㄍㄕ
有點甜=ㄧㄉㄊ
笑鬧人間=ㄒㄋㄖㄐ
無聲情歌=ㄨㄕㄑㄍ
以冬=ㄧㄉ
牽教=ㄑㄐ
相看兩不厭=ㄒㄎㄌㄅㄧ
假如=ㄐㄖ
巴黎草莓=ㄅㄌㄘㄇ
蕭煌奇=ㄒㄏㄑ
都給我快樂=ㄉㄍㄨㄎㄌ
最初的記憶=ㄗㄔㄉㄐㄧ
抱著你=ㄅㄓㄋ
周杰倫,梁心頤=ㄓㄐㄌ,ㄌㄒㄧ
最後一夜(純伴奏)=ㄗㄏㄧㄧ(ㄔㄅㄗ)
流浪狗(純伴奏)=ㄌㄌㄍ(ㄔㄅㄗ)
一天到晚游泳的魚=ㄧㄊㄉㄨㄧㄩㄉㄩ
等你說愛我=ㄉㄋㄕㄞㄨ
木小雅=ㄇㄒㄧ
東山再起=ㄉㄕㄗㄑ
思念來借過=ㄙㄋㄌㄐㄍ
執素兮=ㄓㄙㄒ
無情的電影票=ㄨㄑㄉㄉㄧㄆ
動不動就說愛我=ㄉㄅㄉㄐㄕㄞㄨ
錯愛的人(純伴奏)=ㄘㄞㄉㄖ(ㄔㄅㄗ)
微笑以後=ㄨㄒㄧㄏ
大笨鐘(純伴奏)=ㄉㄅㄓ(ㄔㄅㄗ)
痴情有啥意義=ㄔㄑㄧㄕㄧㄧ
洪百慧徐立鴻=ㄏㄅㄏㄒㄌㄏ
擁抱你離去=ㄩㄅㄋㄌㄑ
愛情代價=ㄞㄑㄉㄐ
迓係好所在(純伴奏)=ㄧㄒㄏㄙㄗ(ㄔㄅㄗ)
看花=ㄎㄏ
春雨晨光=ㄔㄩㄔㄍ
只有分離=ㄓㄧㄈㄌ
順時針=ㄕㄕㄓ
向蕙玲,劉信明=ㄒㄏㄌ,ㄌㄒㄇ
愛你一萬年=ㄞㄋㄧㄨㄋ
陳淑萍=ㄔㄕㄆ
練習=ㄌㄒ
等你願意=ㄉㄋㄩㄧ
三月裡的小雨(純伴奏)=ㄙㄩㄌㄉㄒㄩ(ㄔㄅㄗ)
我還想她(純伴奏)=ㄨㄏㄒㄊ(ㄔㄅㄗ)
十分愛=ㄕㄈㄞ
一顆謙卑的心=ㄧㄎㄑㄅㄉㄒ
我們一起禱告吧=ㄨㄇㄧㄑㄉㄍㄅ
自欺欺人=ㄗㄑㄑㄖ
惜福=ㄒㄈ
最小的偉大=ㄗㄒㄉㄨㄉ
上弦月=ㄕㄒㄩ
恋音と雨空=ㄌㄧとㄩㄎ
走味的咖啡=ㄗㄨㄉㄎㄈ
我曾=ㄨㄘ
梁靜茹=ㄌㄐㄖ
再見小時候=ㄗㄐㄒㄕㄏ
永不失聯的愛=ㄩㄅㄕㄌㄉㄞ
說故事的歌=ㄕㄍㄕㄉㄍ
心裡的孩子=ㄒㄌㄉㄏㄗ
薛凱琪方大同=ㄒㄎㄑㄈㄉㄊ
葉炫清=ㄧㄒㄑ
自由行=ㄗㄧㄒ
荊棘裡的花=ㄐㄐㄌㄉㄏ
來鹿港七逃=ㄌㄌㄍㄑㄊ
郭書瑤=ㄍㄕㄧ
今夜又擱塊落雨=ㄐㄧㄧㄍㄎㄌㄩ
感情生活=ㄍㄑㄕㄏ
西海情歌=ㄒㄏㄑㄍ
別去問他好嗎=ㄅㄑㄨㄊㄏㄇ
陰天快樂=ㄧㄊㄎㄌ
你的眼睛像星星=ㄋㄉㄧㄐㄒㄒㄒ
不被祝福的幸福=ㄅㄅㄓㄈㄉㄒㄈ
你的姑娘=ㄋㄉㄍㄋ
袁小迪,陳小菁=ㄩㄒㄉ,ㄔㄒㄐ
潘美辰=ㄆㄇㄔ
那雙看不見的手=ㄋㄕㄎㄅㄐㄉㄕ
黑玫瑰=ㄏㄇㄍ
愛的代價=ㄞㄉㄉㄐ
想你的夜(純伴奏)=ㄒㄋㄉㄧ(ㄔㄅㄗ)
不見了=ㄅㄐㄌ
無所謂=ㄨㄙㄨ
台北沉睡了=ㄊㄅㄔㄕㄌ
王新蓮=ㄨㄒㄌ
我無所謂=ㄨㄨㄙㄨ
大家樂=ㄉㄐㄌ
渡紅塵(純伴奏)=ㄉㄏㄔ(ㄔㄅㄗ)
黃昏高雄港=ㄏㄏㄍㄒㄍ
謝謝祢=ㄒㄒㄋ
時間博物館=ㄕㄐㄅㄨㄍ
任賢齊梁漢文=ㄖㄒㄑㄌㄏㄨ
相對論=ㄒㄉㄌ
目擊者=ㄇㄐㄓ
為你付出=ㄨㄋㄈㄔ
從開始到現在=ㄘㄎㄕㄉㄒㄗ
一起去峇里=ㄧㄑㄑㄎㄌ
司機大哥=ㄙㄐㄉㄍ
楊青倩,曹格=ㄧㄑㄑ,ㄘㄍ
傷心的我=ㄕㄒㄉㄨ
那個女孩=ㄋㄍㄋㄏ
一覺醒來=ㄧㄐㄒㄌ
玫瑰玫瑰我愛你(純伴奏)=ㄇㄍㄇㄍㄨㄞㄋ(ㄔㄅㄗ)
逆流的淚=ㄋㄌㄉㄌ
黑暗中漫舞=ㄏㄢㄓㄇㄨ
裂變=ㄌㄅ
夜訪吸血鬼=ㄧㄈㄒㄒㄍ
甜甜甜=ㄊㄊㄊ
曾寶儀=ㄗㄅㄧ
千年之戀=ㄑㄋㄓㄌ
後會無期=ㄏㄏㄨㄑ
劉明湘=ㄌㄇㄒ
另存寂寞=ㄌㄘㄐㄇ
製造浪漫(純伴奏)=ㄓㄗㄌㄇ(ㄔㄅㄗ)
預謀(純伴奏)=ㄩㄇ(ㄔㄅㄗ)
後樂園=ㄏㄌㄩ
我是真的愛上你=ㄨㄕㄓㄉㄞㄕㄋ
有影美=ㄧㄧㄇ
別客氣(純伴奏)=ㄅㄎㄑ(ㄔㄅㄗ)
老月光=ㄌㄩㄍ
我要你=ㄨㄧㄋ
堅強的蝴蝶=ㄐㄑㄉㄏㄉ
我們的情人節=ㄨㄇㄉㄑㄖㄐ
用心聽=ㄩㄒㄊ
假裝愛過=ㄐㄓㄞㄍ
幸福的等待(純伴奏)=ㄒㄈㄉㄉㄉ(ㄔㄅㄗ)
小人物大公主=ㄒㄖㄨㄉㄍㄓ
都給妳=ㄉㄍㄋ
愛無價=ㄞㄨㄐ
紅顏劫=ㄏㄧㄐ
現在不跳舞要幹嘛=ㄒㄗㄅㄊㄨㄧㄍㄇ
釋放自己(純伴奏)=ㄕㄈㄗㄐ(ㄔㄅㄗ)
辰亦儒=ㄔㄧㄖ
主耶和華是我的幫助=ㄓㄧㄏㄏㄕㄨㄉㄅㄓ
幸福的時光=ㄒㄈㄉㄕㄍ
呼吸不說謊=ㄏㄒㄅㄕㄏ
樂團=ㄩㄊ
黃思婷=ㄏㄙㄊ
說謊(純伴奏)=ㄕㄏ(ㄔㄅㄗ)
如果沒有你=ㄖㄍㄇㄧㄋ
學貓叫=ㄒㄇㄐ
彼個所在=ㄅㄍㄙㄗ
那是你離開了北京的生活=ㄋㄕㄋㄌㄎㄌㄅㄐㄉㄕㄏ
大阪小雨(純伴奏)=ㄉㄅㄒㄩ(ㄔㄅㄗ)
妳是我最深愛的人=ㄋㄕㄨㄗㄕㄞㄉㄖ
袁婭維=ㄩㄧㄨ
唇印=ㄔㄧ
魂縈舊夢=ㄏㄧㄐㄇ
春雨彎刀=ㄔㄩㄨㄉ
天色很暗=ㄊㄙㄏㄢ
鄭俊弘=ㄓㄐㄏ
後生=ㄏㄕ
而我知道=ㄦㄨㄓㄉ
妳幸福就好=ㄋㄒㄈㄐㄏ
呼倫貝爾大草原=ㄏㄌㄅㄦㄉㄘㄩ
超級冠軍=ㄔㄐㄍㄐ
新的一天=ㄒㄉㄧㄊ
別愛我=ㄅㄞㄨ
你身邊=ㄋㄕㄅ
賀一航=ㄏㄧㄏ
主你是我的一切=ㄓㄋㄕㄨㄉㄧㄑ
我愛過=ㄨㄞㄍ
蓮=ㄌ
鄧麗君=ㄉㄌㄐ
最佳聽眾=ㄗㄐㄊㄓ
偶陣雨=ㄡㄓㄩ
怪物=ㄍㄨ
花的嫁紗=ㄏㄉㄐㄕ
塵埃=ㄔㄞ
我們青春=ㄨㄇㄑㄔ
女人的愛情(純伴奏)=ㄋㄖㄉㄞㄑ(ㄔㄅㄗ)
未央歌(純伴奏)=ㄨㄧㄍ(ㄔㄅㄗ)
底片=ㄉㄆ
下一首情歌=ㄒㄧㄕㄑㄍ
曖昧=ㄞㄇ
綠洲=ㄌㄓ
葉復台=ㄧㄈㄊ
丁噹,嚴爵=ㄉㄉ,ㄧㄐ
情路=ㄑㄌ
我是真的愛過你=ㄨㄕㄓㄉㄞㄍㄋ
扶搖(純伴奏)=ㄈㄧ(ㄔㄅㄗ)
天亮就分手=ㄊㄌㄐㄈㄕ
孤芳自賞=ㄍㄈㄗㄕ
茫霧之戀=ㄇㄨㄓㄌ
鄭家純(雞排妹)=ㄓㄐㄔ(ㄐㄆㄇ)
白冰冰曾治豪=ㄅㄅㄅㄘㄓㄏ
牽情=ㄑㄑ
大手牽著小手=ㄉㄕㄑㄓㄒㄕ
帥到分手(純伴奏)=ㄕㄉㄈㄕ(ㄔㄅㄗ)
祝你順風=ㄓㄋㄕㄈ
方阡翊=ㄈㄑㄧ
王芷蕾=ㄨㄓㄌ
古老的大鐘=ㄍㄌㄉㄉㄓ
冷漠,楊小曼=ㄌㄇ,ㄧㄒㄇ
獨立=ㄉㄌ
與我無關(純伴奏)=ㄩㄨㄨㄍ(ㄔㄅㄗ)
志明與春嬌=ㄓㄇㄩㄔㄐ
最愛的人=ㄗㄞㄉㄖ
九張機(純伴奏)=ㄐㄓㄐ(ㄔㄅㄗ)
張克帆=ㄓㄎㄈ
陳慧琳=ㄔㄏㄌ
一直很安靜=ㄧㄓㄏㄢㄐ
心欲止水=ㄒㄩㄓㄕ
吳卓源=ㄨㄓㄩ
遍地開花=ㄅㄉㄎㄏ
王力宏,章子怡=ㄨㄌㄏ,ㄓㄗㄧ
蕭閎仁=ㄒㄏㄖ
李克勤,周深=ㄌㄎㄑ,ㄓㄕ
一代女皇=ㄧㄉㄋㄏ
繁華攏是夢(純伴奏)=ㄈㄏㄌㄕㄇ(ㄔㄅㄗ)
擋不住的太陽=ㄉㄅㄓㄉㄊㄧ
明年今日=ㄇㄋㄐㄖ
天涯海角=ㄊㄧㄏㄐ
盧冠廷=ㄌㄍㄊ
天亮以後說分手=ㄊㄌㄧㄏㄕㄈㄕ
人間=ㄖㄐ
立冬=ㄌㄉ
諾亞方舟(純伴奏)=ㄋㄧㄈㄓ(ㄔㄅㄗ)
港邊男兒=ㄍㄅㄋㄦ
酸鳳梨=ㄙㄈㄌ
一枝擔竿=ㄧㄓㄉㄍ
幸福的寄望=ㄒㄈㄉㄐㄨ
水果共和國=ㄕㄍㄍㄏㄍ
我們真的幸福了嗎=ㄨㄇㄓㄉㄒㄈㄌㄇ
沙漠駱駝=ㄕㄇㄌㄊ
今天妳最漂亮=ㄐㄊㄋㄗㄆㄌ
你的眼睛像星星(純伴奏)=ㄋㄉㄧㄐㄒㄒㄒ(ㄔㄅㄗ)
野摩托(純伴奏)=ㄧㄇㄊ(ㄔㄅㄗ)
不痛多好=ㄅㄊㄉㄏ
霧=ㄨ
伊能靜=ㄧㄋㄐ
敢不敢=ㄍㄅㄍ
代號魂斗羅=ㄉㄏㄏㄉㄌ
念念不忘=ㄋㄋㄅㄨ
台灣的心跳聲(純伴奏)=ㄊㄨㄉㄒㄊㄕ(ㄔㄅㄗ)
邱鋒澤,文慧如=ㄑㄈㄗ,ㄨㄏㄖ
三人遊(純伴奏)=ㄙㄖㄧ(ㄔㄅㄗ)
譚維維=ㄊㄨㄨ
千山萬水=ㄑㄕㄨㄕ
故鄉的風(純伴奏)=ㄍㄒㄉㄈ(ㄔㄅㄗ)
室友(純伴奏)=ㄕㄧ(ㄔㄅㄗ)
小丑的姿態=ㄒㄔㄉㄗㄊ
江蕙,施文彬=ㄐㄏ,ㄕㄨㄅ
愛你愛我=ㄞㄋㄞㄨ
顏力妃=ㄧㄌㄈ
缺口精密=ㄑㄎㄐㄇ
多桑=ㄉㄙ
天涼好個秋=ㄊㄌㄏㄍㄑ
不老的傳說(純伴奏)=ㄅㄌㄉㄔㄕ(ㄔㄅㄗ)
葬心(純伴奏)=ㄗㄒ(ㄔㄅㄗ)
鄺美雲=ㄎㄇㄩ
翅膀=ㄔㄅ
黑輪伯仔=ㄏㄌㄅㄗ
甘心替代你=ㄍㄒㄊㄉㄋ
我很想愛他(純伴奏)=ㄨㄏㄒㄞㄊ(ㄔㄅㄗ)
月光手札=ㄩㄍㄕㄓ
我的家要榮耀主=ㄨㄉㄐㄧㄖㄧㄓ
融雪之前=ㄖㄒㄓㄑ
長大以後=ㄓㄉㄧㄏ
出山(純伴奏)=ㄔㄕ(ㄔㄅㄗ)
無心石=ㄨㄒㄕ
陪你看星星(純伴奏)=ㄆㄋㄎㄒㄒ(ㄔㄅㄗ)
不要告别=ㄅㄧㄍ别
天窗(純伴奏)=ㄊㄔ(ㄔㄅㄗ)
劉辰希=ㄌㄔㄒ
單身動物園=ㄉㄕㄉㄨㄩ
星野源=ㄒㄧㄩ
如你所願=ㄖㄋㄙㄩ
為了愛夢一生=ㄨㄌㄞㄇㄧㄕ
男朋友=ㄋㄆㄧ
青花瓷(純伴奏)=ㄑㄏㄘ(ㄔㄅㄗ)
完美的一天=ㄨㄇㄉㄧㄊ
承認=ㄔㄖ
後來(純伴奏)=ㄏㄌ(ㄔㄅㄗ)
舊鞋=ㄐㄒ
最幸福的事=ㄗㄒㄈㄉㄕ
江蕙,江淑娜=ㄐㄏ,ㄐㄕㄋ
黃昏(純伴奏)=ㄏㄏ(ㄔㄅㄗ)
煙燻妝=ㄧㄒㄓ
心愛的=ㄒㄞㄉ
黑色毛衣(純伴奏)=ㄏㄙㄇㄧ(ㄔㄅㄗ)
草東沒有派對=ㄘㄉㄇㄧㄆㄉ
順仔你著愛讀冊=ㄕㄗㄋㄓㄞㄉㄘ
不會太久=ㄅㄏㄊㄐ
偏愛=ㄆㄞ
全世界都停電=ㄑㄕㄐㄉㄊㄉ
港都好男兒(純伴奏)=ㄍㄉㄏㄋㄦ(ㄔㄅㄗ)
帶我走=ㄉㄨㄗ
曹雅雯,許富凱=ㄘㄧㄨ,ㄒㄈㄎ
孤獨(純伴奏)=ㄍㄉ(ㄔㄅㄗ)
怎麼了(純伴奏)=ㄗㄇㄌ(ㄔㄅㄗ)
失戀太少=ㄕㄌㄊㄕ
打噴嚏(發燒快版)=ㄉㄆㄊ(ㄈㄕㄎㄅ)
回到以前=ㄏㄉㄧㄑ
原味的夏天=ㄩㄨㄉㄒㄊ
斯芬克斯(純伴奏)=ㄙㄈㄎㄙ(ㄔㄅㄗ)
愛情之所以為愛情(純伴奏)=ㄞㄑㄓㄙㄧㄨㄞㄑ(ㄔㄅㄗ)
說故事的歌(純伴奏)=ㄕㄍㄕㄉㄍ(ㄔㄅㄗ)
那年的情書=ㄋㄋㄉㄑㄕ
熊仔=ㄒㄗ
直到我遇見了你(純伴奏)=ㄓㄉㄨㄩㄐㄌㄋ(ㄔㄅㄗ)
寶島曼波=ㄅㄉㄇㄆ
林明禎=ㄌㄇㄓ
胡彥斌=ㄏㄧㄅ
多麼多麼愛你=ㄉㄇㄉㄇㄞㄋ
討厭下雨天=ㄊㄧㄒㄩㄊ
王北車=ㄨㄅㄔ
瘦子=ㄕㄗ
下一次戀愛=ㄒㄧㄘㄌㄞ
水瓶裡的魚=ㄕㄆㄌㄉㄩ
拼什麼=ㄆㄕㄇ
啾咪啾咪=ㄐㄇㄐㄇ
大地回春滿庭芳=ㄉㄉㄏㄔㄇㄊㄈ
甲妳惜命命=ㄐㄋㄒㄇㄇ
披星戴月的想你=ㄆㄒㄉㄩㄉㄒㄋ
那些你很冒險的夢=ㄋㄒㄋㄏㄇㄒㄉㄇ
忘記時間=ㄨㄐㄕㄐ
張智霖=ㄓㄓㄌ
何耀珊=ㄏㄧㄕ
安娜的櫥窗=ㄢㄋㄉㄔㄔ
一切都是因為愛=ㄧㄑㄉㄕㄧㄨㄞ
王俊琪=ㄨㄐㄑ
今夜妳會不會來(粵)=ㄐㄧㄋㄏㄅㄏㄌ(ㄩ)
月亮之上=ㄩㄌㄓㄕ
寂寞寂寞就好=ㄐㄇㄐㄇㄐㄏ
小聰明=ㄒㄘㄇ
月兒又彎彎=ㄩㄦㄧㄨㄨ
分(純伴奏)=ㄈ(ㄔㄅㄗ)
飄移=ㄆㄧ
舊鞋(純伴奏)=ㄐㄒ(ㄔㄅㄗ)
東西=ㄉㄒ
漸暖=ㄐㄋ
陳芳語=ㄔㄈㄩ
情難斷夢抹醒(純伴奏)=ㄑㄋㄉㄇㄇㄒ(ㄔㄅㄗ)
你不知道的事=ㄋㄅㄓㄉㄉㄕ
除此之外=ㄔㄘㄓㄨ
多岐川舞子=ㄉㄑㄔㄨㄗ
旅途=ㄌㄊ
我不好愛=ㄨㄅㄏㄞ
蔡卓妍=ㄘㄓㄧ
無印良品=ㄨㄧㄌㄆ
忘了你忘了我=ㄨㄌㄋㄨㄌㄨ
麥田捕手=ㄇㄊㄅㄕ
浪人琵琶(純伴奏)=ㄌㄖㄆㄆ(ㄔㄅㄗ)
梨山痴情花=ㄌㄕㄔㄑㄏ
你是愛我的=ㄋㄕㄞㄨㄉ
多年以後=ㄉㄋㄧㄏ
平凡相依=ㄆㄈㄒㄧ
陳百強=ㄔㄅㄑ
李宗盛,伍佰=ㄌㄗㄕ,ㄨㄅ
簡單的幸福=ㄐㄉㄉㄒㄈ
化胎=ㄏㄊ
溫偉杰=ㄨㄨㄐ
禱告的大軍=ㄉㄍㄉㄉㄐ
逍遙嘆=ㄒㄧㄊ
敲敲我的頭(純伴奏)=ㄑㄑㄨㄉㄊ(ㄔㄅㄗ)
談詩玲=ㄊㄕㄌ
長崎蝴蝶姑娘(純伴奏)=ㄔㄑㄏㄉㄍㄋ(ㄔㄅㄗ)
三個人=ㄙㄍㄖ
幸福的聲音=ㄒㄈㄉㄕㄧ
沒有人知道=ㄇㄧㄖㄓㄉ
愛到瘋癲=ㄞㄉㄈㄉ
阿爸=ㄚㄅ
醒了=ㄒㄌ
怨偶=ㄩㄡ
遠距離的愛=ㄩㄐㄌㄉㄞ
痛醒=ㄊㄒ
鬥陣=ㄉㄓ
奇妙能力歌=ㄑㄇㄋㄌㄍ
何潔=ㄏㄐ
好好過=ㄏㄏㄍ
闖空門=ㄔㄎㄇ
天燈啊(純伴奏)=ㄊㄉㄚ(ㄔㄅㄗ)
有外愛=ㄧㄨㄞ
遊樂=ㄧㄌ
美妙生活=ㄇㄇㄕㄏ
天亮說晚安=ㄊㄌㄕㄨㄢ
含淚跳恰恰=ㄏㄌㄊㄑㄑ
熱線你和我(純伴奏)=ㄖㄒㄋㄏㄨ(ㄔㄅㄗ)
浪子回頭=ㄌㄗㄏㄊ
第一次=ㄉㄧㄘ
難過情關=ㄋㄍㄑㄍ
拉手=ㄌㄕ
光良=ㄍㄌ
那個誰(純伴奏)=ㄋㄍㄕ(ㄔㄅㄗ)
馬宜中=ㄇㄧㄓ
將軍=ㄐㄐ
謝宜君,陳隨意=ㄒㄧㄐ,ㄔㄙㄧ
你的情歌(純伴奏)=ㄋㄉㄑㄍ(ㄔㄅㄗ)
心甘情願(純伴奏)=ㄒㄍㄑㄩ(ㄔㄅㄗ)
白露(純伴奏)=ㄅㄌ(ㄔㄅㄗ)
泡麵=ㄆㄇ
劉艾立,小宇=ㄌㄞㄌ,ㄒㄩ
吳映潔=ㄨㄧㄐ
島嶼天光(純伴奏)=ㄉㄩㄊㄍ(ㄔㄅㄗ)
聽愛=ㄊㄞ
我的好兄弟=ㄨㄉㄏㄒㄉ
雨中之花=ㄩㄓㄓㄏ
請你給我好一點的情敵(純伴奏)=ㄑㄋㄍㄨㄏㄧㄉㄉㄑㄉ(ㄔㄅㄗ)
不在乎他=ㄅㄗㄏㄊ
愛上他不只是我的錯=ㄞㄕㄊㄅㄓㄕㄨㄉㄘ
台灣位華語歌手共同錄唱=ㄊㄨㄨㄏㄩㄍㄕㄍㄊㄌㄔ
是他不配=ㄕㄊㄅㄆ
世上只有=ㄕㄕㄓㄧ
壞脾氣=ㄏㄆㄑ
女人何苦為難女人=ㄋㄖㄏㄎㄨㄋㄋㄖ
明仔載=ㄇㄗㄗ
執迷不悟=ㄓㄇㄅㄨ
寄明月=ㄐㄇㄩ
春風少年兄=ㄔㄈㄕㄋㄒ
博物館=ㄅㄨㄍ
存在(純伴奏)=ㄘㄗ(ㄔㄅㄗ)
天使都哭了=ㄊㄕㄉㄎㄌ
或是一首歌=ㄏㄕㄧㄕㄍ
最美的時光(純伴奏)=ㄗㄇㄉㄕㄍ(ㄔㄅㄗ)
楊千嬅=ㄧㄑㄏ
口的形狀=ㄎㄉㄒㄓ
難忘的初戀情人=ㄋㄨㄉㄔㄌㄑㄖ
童安格=ㄊㄢㄍ
極光=ㄐㄍ
陳藝搏=ㄔㄧㄅ
落大雨彼一日(純伴奏)=ㄌㄉㄩㄅㄧㄖ(ㄔㄅㄗ)
吳青峰蕭敬騰=ㄨㄑㄈㄒㄐㄊ
江蕙=ㄐㄏ
雪の華=ㄒのㄏ
盜將行(純伴奏)=ㄉㄐㄒ(ㄔㄅㄗ)
黃色月亮=ㄏㄙㄩㄌ
理想時代=ㄌㄒㄕㄉ
甄妮=ㄓㄋ
王子=ㄨㄗ
撥接(純伴奏)=ㄅㄐ(ㄔㄅㄗ)
你並不懂我(純伴奏)=ㄋㄅㄅㄉㄨ(ㄔㄅㄗ)
澎湖戀歌=ㄆㄏㄌㄍ
少年董=ㄕㄋㄉ
我就是愛你=ㄨㄐㄕㄞㄋ
永遠不再(純伴奏)=ㄩㄩㄅㄗ(ㄔㄅㄗ)
太空人(純伴奏)=ㄊㄎㄖ(ㄔㄅㄗ)
心寒=ㄒㄏ
五月天,孫燕姿=ㄨㄩㄊ,ㄙㄧㄗ
她往月亮走=ㄊㄨㄩㄌㄗ
你不是我=ㄋㄅㄕㄨ
心愛的對不起=ㄒㄞㄉㄉㄅㄑ
堅強的鬥志=ㄐㄑㄉㄉㄓ
水色=ㄕㄙ
幸福的理由=ㄒㄈㄉㄌㄧ
墓仔埔也敢去=ㄇㄗㄆㄧㄍㄑ
愛的告白=ㄞㄉㄍㄅ
蕭煌奇,安心亞=ㄒㄏㄑ,ㄢㄒㄧ
相思無用=ㄒㄙㄨㄩ
洪百慧,莊振凱=ㄏㄅㄏ,ㄓㄓㄎ
林志穎=ㄌㄓㄧ
喊出我的名字=ㄏㄔㄨㄉㄇㄗ
甜甜圈=ㄊㄊㄑ
十一哥=ㄕㄧㄍ
耳朵=ㄦㄉ
我的眼睛在下雨=ㄨㄉㄧㄐㄗㄒㄩ
堅持(純伴奏)=ㄐㄔ(ㄔㄅㄗ)
潘安邦=ㄆㄢㄅ
一生只愛你=ㄧㄕㄓㄞㄋ
丁國琳=ㄉㄍㄌ
忘了怎麼快樂=ㄨㄌㄗㄇㄎㄌ
大荒神域錄=ㄉㄏㄕㄩㄌ
用淚寫緣份=ㄩㄌㄒㄩㄈ
眷戀=ㄐㄌ
永遠在身邊=ㄩㄩㄗㄕㄅ
幾分之幾(純伴奏)=ㄐㄈㄓㄐ(ㄔㄅㄗ)
原諒我=ㄩㄌㄨ
無名之輩=ㄨㄇㄓㄅ
王恰恰=ㄨㄑㄑ
等你回來=ㄉㄋㄏㄌ
會長大的幸福=ㄏㄓㄉㄉㄒㄈ
台灣近位華語歌手共同錄唱=ㄊㄨㄐㄨㄏㄩㄍㄕㄍㄊㄌㄔ
今生未了情=ㄐㄕㄨㄌㄑ
其實我=ㄑㄕㄨ
風箏(純伴奏)=ㄈㄓ(ㄔㄅㄗ)
世界未末日=ㄕㄐㄨㄇㄖ
活著=ㄏㄓ
潛意式的殘酷=ㄑㄧㄕㄉㄘㄎ
童年末日=ㄊㄋㄇㄖ
順服=ㄕㄈ
孤女的願望=ㄍㄋㄉㄩㄨ
高聲唱=ㄍㄕㄔ
我看見的世界=ㄨㄎㄐㄉㄕㄐ
無人之島=ㄨㄖㄓㄉ
袖手旁觀=ㄒㄕㄆㄍ
海角天涯=ㄏㄐㄊㄧ
你和我的時光=ㄋㄏㄨㄉㄕㄍ
星空(純伴奏)=ㄒㄎ(ㄔㄅㄗ)
女人的一生=ㄋㄖㄉㄧㄕ
夢中的情話(純伴奏)=ㄇㄓㄉㄑㄏ(ㄔㄅㄗ)
我曾用心愛著你=ㄨㄘㄩㄒㄞㄓㄋ
任性(純伴奏)=ㄖㄒ(ㄔㄅㄗ)
愛情的無奈=ㄞㄑㄉㄨㄋ
客家本色(純伴奏)=ㄎㄐㄅㄙ(ㄔㄅㄗ)
不能跟情人說的話=ㄅㄋㄍㄑㄖㄕㄉㄏ
葉璦菱=ㄧㄞㄌ
章孬玩=ㄓㄏㄨ
蔡琴=ㄘㄑ
我們的總和=ㄨㄇㄉㄗㄏ
殷正洋=ㄧㄓㄧ
真情比酒濃(純伴奏)=ㄓㄑㄅㄐㄋ(ㄔㄅㄗ)
柏松=ㄅㄙ
你聽聽就好(純伴奏)=ㄋㄊㄊㄐㄏ(ㄔㄅㄗ)
李茂山=ㄌㄇㄕ
難破船=ㄋㄆㄔ
原來你什麼都不要=ㄩㄌㄋㄕㄇㄉㄅㄧ
楊芳儀=ㄧㄈㄧ
男人情女人心(純伴奏)=ㄋㄖㄑㄋㄖㄒ(ㄔㄅㄗ)
東區東區=ㄉㄑㄉㄑ
依然愛你(純伴奏)=ㄧㄖㄞㄋ(ㄔㄅㄗ)
天高地厚=ㄊㄍㄉㄏ
障眼法=ㄓㄧㄈ
哪裡只得我共你=ㄋㄌㄓㄉㄨㄍㄋ
不傷心=ㄅㄕㄒ
守候=ㄕㄏ
店小二=ㄉㄒㄦ
盧凱彤=ㄌㄎㄊ
忘了我=ㄨㄌㄨ
掌紋算命=ㄓㄨㄙㄇ
人質=ㄖㄓ
愛是神馬=ㄞㄕㄕㄇ
揀選=ㄐㄒ
櫻花姐妹=ㄧㄏㄐㄇ
友情=ㄧㄑ
讓我為你唱情歌(純伴奏)=ㄖㄨㄨㄋㄔㄑㄍ(ㄔㄅㄗ)
旅程(純伴奏)=ㄌㄔ(ㄔㄅㄗ)
最靚个阿婆=ㄗㄐㄍㄚㄆ
風塵淚=ㄈㄔㄌ
馬馬=ㄇㄇ
江蕙,阿杜=ㄐㄏ,ㄚㄉ
愛我恨我=ㄞㄨㄏㄨ
與祢更靠近=ㄩㄋㄍㄎㄐ
秋天別來=ㄑㄊㄅㄌ
任性=ㄖㄒ
讓每個人都心碎=ㄖㄇㄍㄖㄉㄒㄙ
咖啡在等一個人=ㄎㄈㄗㄉㄧㄍㄖ
蘇打綠=ㄙㄉㄌ
感情我講會到做會到=ㄍㄑㄨㄐㄏㄉㄗㄏㄉ
交換餘生=ㄐㄏㄩㄕ
借問眾神明=ㄐㄨㄓㄕㄇ
明天的明天的明天=ㄇㄊㄉㄇㄊㄉㄇㄊ
宋冬野=ㄙㄉㄧ
明天你是否依然愛我=ㄇㄊㄋㄕㄈㄧㄖㄞㄨ
天台的月光=ㄊㄊㄉㄩㄍ
相思爬上心底=ㄒㄙㄆㄕㄒㄉ
妳的樣子=ㄋㄉㄧㄗ
需要你的愛=ㄒㄧㄋㄉㄞ
青青河邊草=ㄑㄑㄏㄅㄘ
你的甜蜜=ㄋㄉㄊㄇ
林強=ㄌㄑ
一笑傾城(純伴奏)=ㄧㄒㄑㄔ(ㄔㄅㄗ)
歌劇魅影=ㄍㄐㄇㄧ
三個心願=ㄙㄍㄒㄩ
超人不會飛=ㄔㄖㄅㄏㄈ
不能講的秘密=ㄅㄋㄐㄉㄇㄇ
愛你沒差=ㄞㄋㄇㄔ
請說客語=ㄑㄕㄎㄩ
孫協志=ㄙㄒㄓ
深海魚子醬=ㄕㄏㄩㄗㄐ
孟美岐=ㄇㄇㄑ
燒酒咖啡=ㄕㄐㄎㄈ
有種離開叫捨不得=ㄧㄓㄌㄎㄐㄕㄅㄉ
殘酷月光(純伴奏)=ㄘㄎㄩㄍ(ㄔㄅㄗ)
一樣的是=ㄧㄧㄉㄕ
吳思賢=ㄨㄙㄒ
花花宇宙=ㄏㄏㄩㄓ
談笑一生=ㄊㄒㄧㄕ
再見(純伴奏)=ㄗㄐ(ㄔㄅㄗ)
薄荷與指甲剪=ㄅㄏㄩㄓㄐㄐ
龍拳=ㄌㄑ
燃燒=ㄖㄕ
&=&
不忘=ㄅㄨ
無能為力=ㄨㄋㄨㄌ
新寫的舊歌=ㄒㄒㄉㄐㄍ
下墜=ㄒㄓ
黃美珍=ㄏㄇㄓ
阿母的一生=ㄚㄇㄉㄧㄕ
水中花(純伴奏)=ㄕㄓㄏ(ㄔㄅㄗ)
鳳飛飛=ㄈㄈㄈ
處暑=ㄔㄕ
我沒資格=ㄨㄇㄗㄍ
感謝你曾來過=ㄍㄒㄋㄘㄌㄍ
戴愛玲,竇智孔=ㄉㄞㄌ,ㄉㄓㄎ
夏天的微笑=ㄒㄊㄉㄨㄒ
啵一個=ㄅㄧㄍ
黎瑞恩=ㄌㄖㄣ
越愛越好(純伴奏)=ㄩㄞㄩㄏ(ㄔㄅㄗ)
幸福的輪廓=ㄒㄈㄉㄌㄎ
